"filename", "language", "XML", "Java", "Java Properties", "comment", "blank", "total"
"/Users/ali/cs5510/Group-Project-5510/RLU-Project-DEC7/RLU-Project/.idea/compiler.xml", "XML", 13, 0, 0, 0, 0, 13
"/Users/ali/cs5510/Group-Project-5510/RLU-Project-DEC7/RLU-Project/.idea/encodings.xml", "XML", 7, 0, 0, 0, 0, 7
"/Users/ali/cs5510/Group-Project-5510/RLU-Project-DEC7/RLU-Project/.idea/jarRepositories.xml", "XML", 20, 0, 0, 0, 0, 20
"/Users/ali/cs5510/Group-Project-5510/RLU-Project-DEC7/RLU-Project/.idea/misc.xml", "XML", 12, 0, 0, 0, 0, 12
"/Users/ali/cs5510/Group-Project-5510/RLU-Project-DEC7/RLU-Project/.idea/uiDesigner.xml", "XML", 124, 0, 0, 0, 0, 124
"/Users/ali/cs5510/Group-Project-5510/RLU-Project-DEC7/RLU-Project/.idea/vcs.xml", "XML", 6, 0, 0, 0, 0, 6
"/Users/ali/cs5510/Group-Project-5510/RLU-Project-DEC7/RLU-Project/pom.xml", "XML", 114, 0, 0, 17, 10, 141
"/Users/ali/cs5510/Group-Project-5510/RLU-Project-DEC7/RLU-Project/src/main/java/rlu/Runners/CoarsePaddedRunner.java", "Java", 0, 30, 0, 0, 11, 41
"/Users/ali/cs5510/Group-Project-5510/RLU-Project-DEC7/RLU-Project/src/main/java/rlu/Runners/CoarseRunner.java", "Java", 0, 30, 0, 0, 11, 41
"/Users/ali/cs5510/Group-Project-5510/RLU-Project-DEC7/RLU-Project/src/main/java/rlu/Runners/ComparisonFineRunner.java", "Java", 0, 0, 0, 46, 1, 47
"/Users/ali/cs5510/Group-Project-5510/RLU-Project-DEC7/RLU-Project/src/main/java/rlu/Runners/FineRunner.java", "Java", 0, 30, 0, 0, 11, 41
"/Users/ali/cs5510/Group-Project-5510/RLU-Project-DEC7/RLU-Project/src/main/java/rlu/Runners/RluMultiRunner.java", "Java", 0, 30, 0, 0, 10, 40
"/Users/ali/cs5510/Group-Project-5510/RLU-Project-DEC7/RLU-Project/src/main/java/rlu/Runners/RunnerBST.java", "Java", 0, 23, 0, 6, 12, 41
"/Users/ali/cs5510/Group-Project-5510/RLU-Project-DEC7/RLU-Project/src/main/java/rlu/Runners/RunnerFineBST.java", "Java", 0, 30, 0, 1, 11, 42
"/Users/ali/cs5510/Group-Project-5510/RLU-Project-DEC7/RLU-Project/src/main/java/rlu/Runners/RunnerURCU.java", "Java", 0, 24, 0, 8, 12, 44
"/Users/ali/cs5510/Group-Project-5510/RLU-Project-DEC7/RLU-Project/src/main/java/rlu/benchmarks/CoarseBSTBenchmark.java", "Java", 0, 238, 0, 81, 43, 362
"/Users/ali/cs5510/Group-Project-5510/RLU-Project-DEC7/RLU-Project/src/main/java/rlu/benchmarks/CoarseSetBenchmark.java", "Java", 0, 251, 0, 81, 45, 377
"/Users/ali/cs5510/Group-Project-5510/RLU-Project-DEC7/RLU-Project/src/main/java/rlu/benchmarks/FineBSTBenchmark.java", "Java", 0, 238, 0, 81, 43, 362
"/Users/ali/cs5510/Group-Project-5510/RLU-Project-DEC7/RLU-Project/src/main/java/rlu/benchmarks/FineSetBenchmark.java", "Java", 0, 248, 0, 80, 44, 372
"/Users/ali/cs5510/Group-Project-5510/RLU-Project-DEC7/RLU-Project/src/main/java/rlu/benchmarks/LockFreeSetBenchmark.java", "Java", 0, 248, 0, 80, 45, 373
"/Users/ali/cs5510/Group-Project-5510/RLU-Project-DEC7/RLU-Project/src/main/java/rlu/benchmarks/RluCGPaddedSetBenchmark.java", "Java", 0, 264, 0, 81, 47, 392
"/Users/ali/cs5510/Group-Project-5510/RLU-Project-DEC7/RLU-Project/src/main/java/rlu/benchmarks/RluCGSetBenchmark.java", "Java", 0, 264, 0, 81, 47, 392
"/Users/ali/cs5510/Group-Project-5510/RLU-Project-DEC7/RLU-Project/src/main/java/rlu/benchmarks/RluCoarseBSTBenchmark.java", "Java", 0, 251, 0, 81, 46, 378
"/Users/ali/cs5510/Group-Project-5510/RLU-Project-DEC7/RLU-Project/src/main/java/rlu/benchmarks/RluFGSetBenchmark.java", "Java", 0, 265, 0, 81, 47, 393
"/Users/ali/cs5510/Group-Project-5510/RLU-Project-DEC7/RLU-Project/src/main/java/rlu/benchmarks/RluFineBSTBenchmark.java", "Java", 0, 251, 0, 81, 46, 378
"/Users/ali/cs5510/Group-Project-5510/RLU-Project-DEC7/RLU-Project/src/main/java/rlu/benchmarks/RluMultiObjectSetBenchmark.java", "Java", 0, 264, 0, 81, 47, 392
"/Users/ali/cs5510/Group-Project-5510/RLU-Project-DEC7/RLU-Project/src/main/java/rlu/benchmarks/URCUCGSetBenchmark.java", "Java", 0, 251, 0, 81, 46, 378
"/Users/ali/cs5510/Group-Project-5510/RLU-Project-DEC7/RLU-Project/src/main/java/rlu/benchmarks/URCUFGSetBenchmark.java", "Java", 0, 251, 0, 81, 46, 378
"/Users/ali/cs5510/Group-Project-5510/RLU-Project-DEC7/RLU-Project/src/main/java/rlu/sets/ComparisonSets/CoarseBST.java", "Java", 0, 167, 0, 2, 46, 215
"/Users/ali/cs5510/Group-Project-5510/RLU-Project-DEC7/RLU-Project/src/main/java/rlu/sets/ComparisonSets/CoarseSet.java", "Java", 0, 69, 0, 0, 21, 90
"/Users/ali/cs5510/Group-Project-5510/RLU-Project-DEC7/RLU-Project/src/main/java/rlu/sets/ComparisonSets/FineBST.java", "Java", 0, 200, 0, 5, 38, 243
"/Users/ali/cs5510/Group-Project-5510/RLU-Project-DEC7/RLU-Project/src/main/java/rlu/sets/ComparisonSets/FineSet.java", "Java", 0, 108, 0, 0, 24, 132
"/Users/ali/cs5510/Group-Project-5510/RLU-Project-DEC7/RLU-Project/src/main/java/rlu/sets/ComparisonSets/LockFreeSet.java", "Java", 0, 105, 0, 0, 30, 135
"/Users/ali/cs5510/Group-Project-5510/RLU-Project-DEC7/RLU-Project/src/main/java/rlu/sets/ComparisonSets/Threads.java", "Java", 0, 5, 0, 0, 3, 8
"/Users/ali/cs5510/Group-Project-5510/RLU-Project-DEC7/RLU-Project/src/main/java/rlu/sets/RLUBST/HeaderBST.java", "Java", 0, 16, 0, 0, 6, 22
"/Users/ali/cs5510/Group-Project-5510/RLU-Project-DEC7/RLU-Project/src/main/java/rlu/sets/RLUBST/RLUBSTNode.java", "Java", 0, 76, 0, 1, 24, 101
"/Users/ali/cs5510/Group-Project-5510/RLU-Project-DEC7/RLU-Project/src/main/java/rlu/sets/RLUBST/RLUCoarseSetBST.java", "Java", 0, 183, 0, 7, 42, 232
"/Users/ali/cs5510/Group-Project-5510/RLU-Project-DEC7/RLU-Project/src/main/java/rlu/sets/RLUBST/RLUFineSetBST.java", "Java", 0, 202, 0, 6, 33, 241
"/Users/ali/cs5510/Group-Project-5510/RLU-Project-DEC7/RLU-Project/src/main/java/rlu/sets/RLUBST/RluThread.java", "Java", 0, 20, 0, 2, 7, 29
"/Users/ali/cs5510/Group-Project-5510/RLU-Project-DEC7/RLU-Project/src/main/java/rlu/sets/RluSets/Header.java", "Java", 0, 20, 0, 0, 4, 24
"/Users/ali/cs5510/Group-Project-5510/RLU-Project-DEC7/RLU-Project/src/main/java/rlu/sets/RluSets/RluMultiObjCoarseSet.java", "Java", 0, 133, 0, 9, 10, 152
"/Users/ali/cs5510/Group-Project-5510/RLU-Project-DEC7/RLU-Project/src/main/java/rlu/sets/RluSets/RluNode.java", "Java", 0, 27, 0, 6, 9, 42
"/Users/ali/cs5510/Group-Project-5510/RLU-Project-DEC7/RLU-Project/src/main/java/rlu/sets/RluSets/RluSetInterface.java", "Java", 0, 6, 0, 19, 6, 31
"/Users/ali/cs5510/Group-Project-5510/RLU-Project-DEC7/RLU-Project/src/main/java/rlu/sets/RluSets/RluThread.java", "Java", 0, 18, 0, 2, 4, 24
"/Users/ali/cs5510/Group-Project-5510/RLU-Project-DEC7/RLU-Project/src/main/java/rlu/sets/RluSets/SingleObjRluCoarseSet.java", "Java", 0, 94, 0, 2, 16, 112
"/Users/ali/cs5510/Group-Project-5510/RLU-Project-DEC7/RLU-Project/src/main/java/rlu/sets/RluSets/SingleObjRluFineSet.java", "Java", 0, 106, 0, 1, 11, 118
"/Users/ali/cs5510/Group-Project-5510/RLU-Project-DEC7/RLU-Project/src/main/java/rlu/sets/RluSets/SingleObjRluPaddedCoarseSet.java", "Java", 0, 96, 0, 3, 13, 112
"/Users/ali/cs5510/Group-Project-5510/RLU-Project-DEC7/RLU-Project/src/main/java/rlu/sets/URCU/CoarseSetURCU.java", "Java", 0, 82, 0, 1, 36, 119
"/Users/ali/cs5510/Group-Project-5510/RLU-Project-DEC7/RLU-Project/src/main/java/rlu/sets/URCU/FineSetURCU.java", "Java", 0, 96, 0, 1, 28, 125
"/Users/ali/cs5510/Group-Project-5510/RLU-Project-DEC7/RLU-Project/src/main/java/rlu/sets/URCU/RcuNode.java", "Java", 0, 22, 0, 0, 8, 30
"/Users/ali/cs5510/Group-Project-5510/RLU-Project-DEC7/RLU-Project/src/main/java/rlu/sets/URCU/RcuSetInterface.java", "Java", 0, 6, 0, 18, 6, 30
"/Users/ali/cs5510/Group-Project-5510/RLU-Project-DEC7/RLU-Project/src/main/java/rlu/sets/URCU/RcuThread.java", "Java", 0, 7, 0, 0, 4, 11
"/Users/ali/cs5510/Group-Project-5510/RLU-Project-DEC7/RLU-Project/src/main/java/rlu/sets/interfaces/ComparableSet.java", "Java", 0, 8, 0, 0, 6, 14
"/Users/ali/cs5510/Group-Project-5510/RLU-Project-DEC7/RLU-Project/src/main/java/rlu/sets/interfaces/ComparisonSet.java", "Java", 0, 6, 0, 0, 4, 10
"/Users/ali/cs5510/Group-Project-5510/RLU-Project-DEC7/RLU-Project/src/main/java/rlu/sets/interfaces/Set.java", "Java", 0, 6, 0, 18, 4, 28
"/Users/ali/cs5510/Group-Project-5510/RLU-Project-DEC7/RLU-Project/src/main/java/rlu/sets/interfaces/Sorted.java", "Java", 0, 7, 0, 0, 5, 12
"/Users/ali/cs5510/Group-Project-5510/RLU-Project-DEC7/RLU-Project/src/main/java/rlu/threads/ComparisonFineReader.java", "Java", 0, 38, 0, 1, 11, 50
"/Users/ali/cs5510/Group-Project-5510/RLU-Project-DEC7/RLU-Project/src/main/java/rlu/threads/ComparisonFineWriter.java", "Java", 0, 38, 0, 1, 11, 50
"/Users/ali/cs5510/Group-Project-5510/RLU-Project-DEC7/RLU-Project/src/main/java/rlu/threads/MultiWriterThread.java", "Java", 0, 38, 0, 3, 11, 52
"/Users/ali/cs5510/Group-Project-5510/RLU-Project-DEC7/RLU-Project/src/main/java/rlu/threads/RcuReader.java", "Java", 0, 36, 0, 2, 12, 50
"/Users/ali/cs5510/Group-Project-5510/RLU-Project-DEC7/RLU-Project/src/main/java/rlu/threads/RcuWriter.java", "Java", 0, 36, 0, 1, 10, 47
"/Users/ali/cs5510/Group-Project-5510/RLU-Project-DEC7/RLU-Project/src/main/java/rlu/threads/ReaderBST.java", "Java", 0, 41, 0, 1, 14, 56
"/Users/ali/cs5510/Group-Project-5510/RLU-Project-DEC7/RLU-Project/src/main/java/rlu/threads/ReaderThread.java", "Java", 0, 36, 0, 2, 12, 50
"/Users/ali/cs5510/Group-Project-5510/RLU-Project-DEC7/RLU-Project/src/main/java/rlu/threads/WriterBST.java", "Java", 0, 41, 0, 1, 13, 55
"/Users/ali/cs5510/Group-Project-5510/RLU-Project-DEC7/RLU-Project/src/main/java/rlu/threads/WriterThread.java", "Java", 0, 36, 0, 2, 10, 48
"/Users/ali/cs5510/Group-Project-5510/RLU-Project-DEC7/RLU-Project/target/classes/rlu/Runners/CoarsePaddedRunner.class", "Java", 0, 30, 0, 0, 0, 30
"/Users/ali/cs5510/Group-Project-5510/RLU-Project-DEC7/RLU-Project/target/classes/rlu/Runners/CoarseRunner.class", "Java", 0, 30, 0, 0, 0, 30
"/Users/ali/cs5510/Group-Project-5510/RLU-Project-DEC7/RLU-Project/target/classes/rlu/Runners/FineRunner.class", "Java", 0, 30, 0, 0, 0, 30
"/Users/ali/cs5510/Group-Project-5510/RLU-Project-DEC7/RLU-Project/target/classes/rlu/Runners/RluMultiRunner.class", "Java", 0, 31, 0, 0, 0, 31
"/Users/ali/cs5510/Group-Project-5510/RLU-Project-DEC7/RLU-Project/target/classes/rlu/Runners/RunnerBST.class", "Java", 0, 24, 0, 0, 0, 24
"/Users/ali/cs5510/Group-Project-5510/RLU-Project-DEC7/RLU-Project/target/classes/rlu/Runners/RunnerFineBST.class", "Java", 0, 28, 0, 0, 0, 28
"/Users/ali/cs5510/Group-Project-5510/RLU-Project-DEC7/RLU-Project/target/classes/rlu/Runners/RunnerURCU.class", "Java", 0, 25, 0, 0, 0, 25
"/Users/ali/cs5510/Group-Project-5510/RLU-Project-DEC7/RLU-Project/target/classes/rlu/benchmarks/CoarseBSTBenchmark$MyState.class", "Java", 0, 30, 0, 0, 0, 30
"/Users/ali/cs5510/Group-Project-5510/RLU-Project-DEC7/RLU-Project/target/classes/rlu/benchmarks/CoarseBSTBenchmark.class", "Java", 0, 118, 0, 0, 0, 118
"/Users/ali/cs5510/Group-Project-5510/RLU-Project-DEC7/RLU-Project/target/classes/rlu/benchmarks/CoarseSetBenchmark$MyState.class", "Java", 0, 29, 0, 0, 0, 29
"/Users/ali/cs5510/Group-Project-5510/RLU-Project-DEC7/RLU-Project/target/classes/rlu/benchmarks/CoarseSetBenchmark.class", "Java", 0, 118, 0, 0, 0, 118
"/Users/ali/cs5510/Group-Project-5510/RLU-Project-DEC7/RLU-Project/target/classes/rlu/benchmarks/FineBSTBenchmark$MyState.class", "Java", 0, 30, 0, 0, 0, 30
"/Users/ali/cs5510/Group-Project-5510/RLU-Project-DEC7/RLU-Project/target/classes/rlu/benchmarks/FineBSTBenchmark.class", "Java", 0, 118, 0, 0, 0, 118
"/Users/ali/cs5510/Group-Project-5510/RLU-Project-DEC7/RLU-Project/target/classes/rlu/benchmarks/FineSetBenchmark$MyState.class", "Java", 0, 26, 0, 0, 0, 26
"/Users/ali/cs5510/Group-Project-5510/RLU-Project-DEC7/RLU-Project/target/classes/rlu/benchmarks/FineSetBenchmark.class", "Java", 0, 119, 0, 0, 0, 119
"/Users/ali/cs5510/Group-Project-5510/RLU-Project-DEC7/RLU-Project/target/classes/rlu/benchmarks/LockFreeSetBenchmark$MyState.class", "Java", 0, 26, 0, 0, 0, 26
"/Users/ali/cs5510/Group-Project-5510/RLU-Project-DEC7/RLU-Project/target/classes/rlu/benchmarks/LockFreeSetBenchmark.class", "Java", 0, 119, 0, 0, 0, 119
"/Users/ali/cs5510/Group-Project-5510/RLU-Project-DEC7/RLU-Project/target/classes/rlu/benchmarks/RluCGPaddedSetBenchmark$GlobalState.class", "Java", 0, 27, 0, 0, 0, 27
"/Users/ali/cs5510/Group-Project-5510/RLU-Project-DEC7/RLU-Project/target/classes/rlu/benchmarks/RluCGPaddedSetBenchmark$ThreadState.class", "Java", 0, 20, 0, 0, 0, 20
"/Users/ali/cs5510/Group-Project-5510/RLU-Project-DEC7/RLU-Project/target/classes/rlu/benchmarks/RluCGPaddedSetBenchmark.class", "Java", 0, 117, 0, 0, 0, 117
"/Users/ali/cs5510/Group-Project-5510/RLU-Project-DEC7/RLU-Project/target/classes/rlu/benchmarks/RluCGSetBenchmark$GlobalState.class", "Java", 0, 27, 0, 0, 0, 27
"/Users/ali/cs5510/Group-Project-5510/RLU-Project-DEC7/RLU-Project/target/classes/rlu/benchmarks/RluCGSetBenchmark$ThreadState.class", "Java", 0, 20, 0, 0, 0, 20
"/Users/ali/cs5510/Group-Project-5510/RLU-Project-DEC7/RLU-Project/target/classes/rlu/benchmarks/RluCGSetBenchmark.class", "Java", 0, 117, 0, 0, 0, 117
"/Users/ali/cs5510/Group-Project-5510/RLU-Project-DEC7/RLU-Project/target/classes/rlu/benchmarks/RluCoarseBSTBenchmark$GlobalState.class", "Java", 0, 27, 0, 0, 0, 27
"/Users/ali/cs5510/Group-Project-5510/RLU-Project-DEC7/RLU-Project/target/classes/rlu/benchmarks/RluCoarseBSTBenchmark$ThreadState.class", "Java", 0, 20, 0, 0, 0, 20
"/Users/ali/cs5510/Group-Project-5510/RLU-Project-DEC7/RLU-Project/target/classes/rlu/benchmarks/RluCoarseBSTBenchmark.class", "Java", 0, 118, 0, 0, 0, 118
"/Users/ali/cs5510/Group-Project-5510/RLU-Project-DEC7/RLU-Project/target/classes/rlu/benchmarks/RluFGSetBenchmark$GlobalState.class", "Java", 0, 26, 0, 0, 0, 26
"/Users/ali/cs5510/Group-Project-5510/RLU-Project-DEC7/RLU-Project/target/classes/rlu/benchmarks/RluFGSetBenchmark$ThreadState.class", "Java", 0, 20, 0, 0, 0, 20
"/Users/ali/cs5510/Group-Project-5510/RLU-Project-DEC7/RLU-Project/target/classes/rlu/benchmarks/RluFGSetBenchmark.class", "Java", 0, 116, 0, 0, 0, 116
"/Users/ali/cs5510/Group-Project-5510/RLU-Project-DEC7/RLU-Project/target/classes/rlu/benchmarks/RluFineBSTBenchmark$GlobalState.class", "Java", 0, 27, 0, 0, 0, 27
"/Users/ali/cs5510/Group-Project-5510/RLU-Project-DEC7/RLU-Project/target/classes/rlu/benchmarks/RluFineBSTBenchmark$ThreadState.class", "Java", 0, 20, 0, 0, 0, 20
"/Users/ali/cs5510/Group-Project-5510/RLU-Project-DEC7/RLU-Project/target/classes/rlu/benchmarks/RluFineBSTBenchmark.class", "Java", 0, 118, 0, 0, 0, 118
"/Users/ali/cs5510/Group-Project-5510/RLU-Project-DEC7/RLU-Project/target/classes/rlu/benchmarks/RluMultiObjectSetBenchmark$GlobalState.class", "Java", 0, 26, 0, 0, 0, 26
"/Users/ali/cs5510/Group-Project-5510/RLU-Project-DEC7/RLU-Project/target/classes/rlu/benchmarks/RluMultiObjectSetBenchmark$ThreadState.class", "Java", 0, 20, 0, 0, 0, 20
"/Users/ali/cs5510/Group-Project-5510/RLU-Project-DEC7/RLU-Project/target/classes/rlu/benchmarks/RluMultiObjectSetBenchmark.class", "Java", 0, 117, 0, 0, 0, 117
"/Users/ali/cs5510/Group-Project-5510/RLU-Project-DEC7/RLU-Project/target/classes/rlu/benchmarks/URCUCGSetBenchmark$GlobalState.class", "Java", 0, 27, 0, 0, 0, 27
"/Users/ali/cs5510/Group-Project-5510/RLU-Project-DEC7/RLU-Project/target/classes/rlu/benchmarks/URCUCGSetBenchmark$ThreadState.class", "Java", 0, 20, 0, 0, 0, 20
"/Users/ali/cs5510/Group-Project-5510/RLU-Project-DEC7/RLU-Project/target/classes/rlu/benchmarks/URCUCGSetBenchmark.class", "Java", 0, 118, 0, 0, 0, 118
"/Users/ali/cs5510/Group-Project-5510/RLU-Project-DEC7/RLU-Project/target/classes/rlu/benchmarks/URCUFGSetBenchmark$GlobalState.class", "Java", 0, 27, 0, 0, 0, 27
"/Users/ali/cs5510/Group-Project-5510/RLU-Project-DEC7/RLU-Project/target/classes/rlu/benchmarks/URCUFGSetBenchmark$ThreadState.class", "Java", 0, 20, 0, 0, 0, 20
"/Users/ali/cs5510/Group-Project-5510/RLU-Project-DEC7/RLU-Project/target/classes/rlu/benchmarks/URCUFGSetBenchmark.class", "Java", 0, 118, 0, 0, 0, 118
"/Users/ali/cs5510/Group-Project-5510/RLU-Project-DEC7/RLU-Project/target/classes/rlu/benchmarks/jmh_generated/CoarseBSTBenchmark_MyState_jmhType.class", "Java", 0, 5, 0, 0, 0, 5
"/Users/ali/cs5510/Group-Project-5510/RLU-Project-DEC7/RLU-Project/target/classes/rlu/benchmarks/jmh_generated/CoarseBSTBenchmark_MyState_jmhType_B1.class", "Java", 0, 8, 0, 0, 0, 8
"/Users/ali/cs5510/Group-Project-5510/RLU-Project-DEC7/RLU-Project/target/classes/rlu/benchmarks/jmh_generated/CoarseBSTBenchmark_MyState_jmhType_B2.class", "Java", 0, 15, 0, 0, 0, 15
"/Users/ali/cs5510/Group-Project-5510/RLU-Project-DEC7/RLU-Project/target/classes/rlu/benchmarks/jmh_generated/CoarseBSTBenchmark_MyState_jmhType_B3.class", "Java", 0, 7, 0, 0, 0, 7
"/Users/ali/cs5510/Group-Project-5510/RLU-Project-DEC7/RLU-Project/target/classes/rlu/benchmarks/jmh_generated/CoarseBSTBenchmark_g16for20_jmhTest.class", "Java", 0, 394, 0, 0, 4, 398
"/Users/ali/cs5510/Group-Project-5510/RLU-Project-DEC7/RLU-Project/target/classes/rlu/benchmarks/jmh_generated/CoarseBSTBenchmark_g16for40_jmhTest.class", "Java", 0, 394, 0, 0, 4, 398
"/Users/ali/cs5510/Group-Project-5510/RLU-Project-DEC7/RLU-Project/target/classes/rlu/benchmarks/jmh_generated/CoarseBSTBenchmark_g16for60_jmhTest.class", "Java", 0, 394, 0, 0, 4, 398
"/Users/ali/cs5510/Group-Project-5510/RLU-Project-DEC7/RLU-Project/target/classes/rlu/benchmarks/jmh_generated/CoarseBSTBenchmark_g16for80_jmhTest.class", "Java", 0, 394, 0, 0, 4, 398
"/Users/ali/cs5510/Group-Project-5510/RLU-Project-DEC7/RLU-Project/target/classes/rlu/benchmarks/jmh_generated/CoarseBSTBenchmark_g24for20_jmhTest.class", "Java", 0, 394, 0, 0, 4, 398
"/Users/ali/cs5510/Group-Project-5510/RLU-Project-DEC7/RLU-Project/target/classes/rlu/benchmarks/jmh_generated/CoarseBSTBenchmark_g24for40_jmhTest.class", "Java", 0, 394, 0, 0, 4, 398
"/Users/ali/cs5510/Group-Project-5510/RLU-Project-DEC7/RLU-Project/target/classes/rlu/benchmarks/jmh_generated/CoarseBSTBenchmark_g24for60_jmhTest.class", "Java", 0, 394, 0, 0, 4, 398
"/Users/ali/cs5510/Group-Project-5510/RLU-Project-DEC7/RLU-Project/target/classes/rlu/benchmarks/jmh_generated/CoarseBSTBenchmark_g24for80_jmhTest.class", "Java", 0, 394, 0, 0, 4, 398
"/Users/ali/cs5510/Group-Project-5510/RLU-Project-DEC7/RLU-Project/target/classes/rlu/benchmarks/jmh_generated/CoarseBSTBenchmark_g32for20_jmhTest.class", "Java", 0, 394, 0, 0, 4, 398
"/Users/ali/cs5510/Group-Project-5510/RLU-Project-DEC7/RLU-Project/target/classes/rlu/benchmarks/jmh_generated/CoarseBSTBenchmark_g32for40_jmhTest.class", "Java", 0, 394, 0, 0, 4, 398
"/Users/ali/cs5510/Group-Project-5510/RLU-Project-DEC7/RLU-Project/target/classes/rlu/benchmarks/jmh_generated/CoarseBSTBenchmark_g32for60_jmhTest.class", "Java", 0, 394, 0, 0, 4, 398
"/Users/ali/cs5510/Group-Project-5510/RLU-Project-DEC7/RLU-Project/target/classes/rlu/benchmarks/jmh_generated/CoarseBSTBenchmark_g32for80_jmhTest.class", "Java", 0, 394, 0, 0, 4, 398
"/Users/ali/cs5510/Group-Project-5510/RLU-Project-DEC7/RLU-Project/target/classes/rlu/benchmarks/jmh_generated/CoarseBSTBenchmark_g8for20_jmhTest.class", "Java", 0, 394, 0, 0, 4, 398
"/Users/ali/cs5510/Group-Project-5510/RLU-Project-DEC7/RLU-Project/target/classes/rlu/benchmarks/jmh_generated/CoarseBSTBenchmark_g8for40_jmhTest.class", "Java", 0, 394, 0, 0, 4, 398
"/Users/ali/cs5510/Group-Project-5510/RLU-Project-DEC7/RLU-Project/target/classes/rlu/benchmarks/jmh_generated/CoarseBSTBenchmark_g8for60_jmhTest.class", "Java", 0, 394, 0, 0, 4, 398
"/Users/ali/cs5510/Group-Project-5510/RLU-Project-DEC7/RLU-Project/target/classes/rlu/benchmarks/jmh_generated/CoarseBSTBenchmark_g8for80_jmhTest.class", "Java", 0, 394, 0, 0, 4, 398
"/Users/ali/cs5510/Group-Project-5510/RLU-Project-DEC7/RLU-Project/target/classes/rlu/benchmarks/jmh_generated/CoarseBSTBenchmark_jmhType.class", "Java", 0, 5, 0, 0, 0, 5
"/Users/ali/cs5510/Group-Project-5510/RLU-Project-DEC7/RLU-Project/target/classes/rlu/benchmarks/jmh_generated/CoarseBSTBenchmark_jmhType_B1.class", "Java", 0, 7, 0, 0, 0, 7
"/Users/ali/cs5510/Group-Project-5510/RLU-Project-DEC7/RLU-Project/target/classes/rlu/benchmarks/jmh_generated/CoarseBSTBenchmark_jmhType_B2.class", "Java", 0, 15, 0, 0, 0, 15
"/Users/ali/cs5510/Group-Project-5510/RLU-Project-DEC7/RLU-Project/target/classes/rlu/benchmarks/jmh_generated/CoarseBSTBenchmark_jmhType_B3.class", "Java", 0, 7, 0, 0, 0, 7
"/Users/ali/cs5510/Group-Project-5510/RLU-Project-DEC7/RLU-Project/target/classes/rlu/benchmarks/jmh_generated/CoarseSetBenchmark_MyState_jmhType.class", "Java", 0, 5, 0, 0, 0, 5
"/Users/ali/cs5510/Group-Project-5510/RLU-Project-DEC7/RLU-Project/target/classes/rlu/benchmarks/jmh_generated/CoarseSetBenchmark_MyState_jmhType_B1.class", "Java", 0, 8, 0, 0, 0, 8
"/Users/ali/cs5510/Group-Project-5510/RLU-Project-DEC7/RLU-Project/target/classes/rlu/benchmarks/jmh_generated/CoarseSetBenchmark_MyState_jmhType_B2.class", "Java", 0, 15, 0, 0, 0, 15
"/Users/ali/cs5510/Group-Project-5510/RLU-Project-DEC7/RLU-Project/target/classes/rlu/benchmarks/jmh_generated/CoarseSetBenchmark_MyState_jmhType_B3.class", "Java", 0, 7, 0, 0, 0, 7
"/Users/ali/cs5510/Group-Project-5510/RLU-Project-DEC7/RLU-Project/target/classes/rlu/benchmarks/jmh_generated/CoarseSetBenchmark_g16for20_jmhTest.class", "Java", 0, 394, 0, 0, 4, 398
"/Users/ali/cs5510/Group-Project-5510/RLU-Project-DEC7/RLU-Project/target/classes/rlu/benchmarks/jmh_generated/CoarseSetBenchmark_g16for40_jmhTest.class", "Java", 0, 394, 0, 0, 4, 398
"/Users/ali/cs5510/Group-Project-5510/RLU-Project-DEC7/RLU-Project/target/classes/rlu/benchmarks/jmh_generated/CoarseSetBenchmark_g16for60_jmhTest.class", "Java", 0, 394, 0, 0, 4, 398
"/Users/ali/cs5510/Group-Project-5510/RLU-Project-DEC7/RLU-Project/target/classes/rlu/benchmarks/jmh_generated/CoarseSetBenchmark_g16for80_jmhTest.class", "Java", 0, 394, 0, 0, 4, 398
"/Users/ali/cs5510/Group-Project-5510/RLU-Project-DEC7/RLU-Project/target/classes/rlu/benchmarks/jmh_generated/CoarseSetBenchmark_g24for20_jmhTest.class", "Java", 0, 394, 0, 0, 4, 398
"/Users/ali/cs5510/Group-Project-5510/RLU-Project-DEC7/RLU-Project/target/classes/rlu/benchmarks/jmh_generated/CoarseSetBenchmark_g24for40_jmhTest.class", "Java", 0, 394, 0, 0, 4, 398
"/Users/ali/cs5510/Group-Project-5510/RLU-Project-DEC7/RLU-Project/target/classes/rlu/benchmarks/jmh_generated/CoarseSetBenchmark_g24for60_jmhTest.class", "Java", 0, 394, 0, 0, 4, 398
"/Users/ali/cs5510/Group-Project-5510/RLU-Project-DEC7/RLU-Project/target/classes/rlu/benchmarks/jmh_generated/CoarseSetBenchmark_g24for80_jmhTest.class", "Java", 0, 394, 0, 0, 4, 398
"/Users/ali/cs5510/Group-Project-5510/RLU-Project-DEC7/RLU-Project/target/classes/rlu/benchmarks/jmh_generated/CoarseSetBenchmark_g32for20_jmhTest.class", "Java", 0, 394, 0, 0, 4, 398
"/Users/ali/cs5510/Group-Project-5510/RLU-Project-DEC7/RLU-Project/target/classes/rlu/benchmarks/jmh_generated/CoarseSetBenchmark_g32for40_jmhTest.class", "Java", 0, 394, 0, 0, 4, 398
"/Users/ali/cs5510/Group-Project-5510/RLU-Project-DEC7/RLU-Project/target/classes/rlu/benchmarks/jmh_generated/CoarseSetBenchmark_g32for60_jmhTest.class", "Java", 0, 394, 0, 0, 4, 398
"/Users/ali/cs5510/Group-Project-5510/RLU-Project-DEC7/RLU-Project/target/classes/rlu/benchmarks/jmh_generated/CoarseSetBenchmark_g32for80_jmhTest.class", "Java", 0, 394, 0, 0, 4, 398
"/Users/ali/cs5510/Group-Project-5510/RLU-Project-DEC7/RLU-Project/target/classes/rlu/benchmarks/jmh_generated/CoarseSetBenchmark_g8for20_jmhTest.class", "Java", 0, 394, 0, 0, 4, 398
"/Users/ali/cs5510/Group-Project-5510/RLU-Project-DEC7/RLU-Project/target/classes/rlu/benchmarks/jmh_generated/CoarseSetBenchmark_g8for40_jmhTest.class", "Java", 0, 394, 0, 0, 4, 398
"/Users/ali/cs5510/Group-Project-5510/RLU-Project-DEC7/RLU-Project/target/classes/rlu/benchmarks/jmh_generated/CoarseSetBenchmark_g8for60_jmhTest.class", "Java", 0, 394, 0, 0, 4, 398
"/Users/ali/cs5510/Group-Project-5510/RLU-Project-DEC7/RLU-Project/target/classes/rlu/benchmarks/jmh_generated/CoarseSetBenchmark_g8for80_jmhTest.class", "Java", 0, 394, 0, 0, 4, 398
"/Users/ali/cs5510/Group-Project-5510/RLU-Project-DEC7/RLU-Project/target/classes/rlu/benchmarks/jmh_generated/CoarseSetBenchmark_jmhType.class", "Java", 0, 5, 0, 0, 0, 5
"/Users/ali/cs5510/Group-Project-5510/RLU-Project-DEC7/RLU-Project/target/classes/rlu/benchmarks/jmh_generated/CoarseSetBenchmark_jmhType_B1.class", "Java", 0, 7, 0, 0, 0, 7
"/Users/ali/cs5510/Group-Project-5510/RLU-Project-DEC7/RLU-Project/target/classes/rlu/benchmarks/jmh_generated/CoarseSetBenchmark_jmhType_B2.class", "Java", 0, 15, 0, 0, 0, 15
"/Users/ali/cs5510/Group-Project-5510/RLU-Project-DEC7/RLU-Project/target/classes/rlu/benchmarks/jmh_generated/CoarseSetBenchmark_jmhType_B3.class", "Java", 0, 7, 0, 0, 0, 7
"/Users/ali/cs5510/Group-Project-5510/RLU-Project-DEC7/RLU-Project/target/classes/rlu/benchmarks/jmh_generated/FineBSTBenchmark_MyState_jmhType.class", "Java", 0, 5, 0, 0, 0, 5
"/Users/ali/cs5510/Group-Project-5510/RLU-Project-DEC7/RLU-Project/target/classes/rlu/benchmarks/jmh_generated/FineBSTBenchmark_MyState_jmhType_B1.class", "Java", 0, 8, 0, 0, 0, 8
"/Users/ali/cs5510/Group-Project-5510/RLU-Project-DEC7/RLU-Project/target/classes/rlu/benchmarks/jmh_generated/FineBSTBenchmark_MyState_jmhType_B2.class", "Java", 0, 15, 0, 0, 0, 15
"/Users/ali/cs5510/Group-Project-5510/RLU-Project-DEC7/RLU-Project/target/classes/rlu/benchmarks/jmh_generated/FineBSTBenchmark_MyState_jmhType_B3.class", "Java", 0, 7, 0, 0, 0, 7
"/Users/ali/cs5510/Group-Project-5510/RLU-Project-DEC7/RLU-Project/target/classes/rlu/benchmarks/jmh_generated/FineBSTBenchmark_g16for20_jmhTest.class", "Java", 0, 394, 0, 0, 4, 398
"/Users/ali/cs5510/Group-Project-5510/RLU-Project-DEC7/RLU-Project/target/classes/rlu/benchmarks/jmh_generated/FineBSTBenchmark_g16for40_jmhTest.class", "Java", 0, 394, 0, 0, 4, 398
"/Users/ali/cs5510/Group-Project-5510/RLU-Project-DEC7/RLU-Project/target/classes/rlu/benchmarks/jmh_generated/FineBSTBenchmark_g16for60_jmhTest.class", "Java", 0, 394, 0, 0, 4, 398
"/Users/ali/cs5510/Group-Project-5510/RLU-Project-DEC7/RLU-Project/target/classes/rlu/benchmarks/jmh_generated/FineBSTBenchmark_g16for80_jmhTest.class", "Java", 0, 394, 0, 0, 4, 398
"/Users/ali/cs5510/Group-Project-5510/RLU-Project-DEC7/RLU-Project/target/classes/rlu/benchmarks/jmh_generated/FineBSTBenchmark_g24for20_jmhTest.class", "Java", 0, 394, 0, 0, 4, 398
"/Users/ali/cs5510/Group-Project-5510/RLU-Project-DEC7/RLU-Project/target/classes/rlu/benchmarks/jmh_generated/FineBSTBenchmark_g24for40_jmhTest.class", "Java", 0, 394, 0, 0, 4, 398
"/Users/ali/cs5510/Group-Project-5510/RLU-Project-DEC7/RLU-Project/target/classes/rlu/benchmarks/jmh_generated/FineBSTBenchmark_g24for60_jmhTest.class", "Java", 0, 394, 0, 0, 4, 398
"/Users/ali/cs5510/Group-Project-5510/RLU-Project-DEC7/RLU-Project/target/classes/rlu/benchmarks/jmh_generated/FineBSTBenchmark_g24for80_jmhTest.class", "Java", 0, 394, 0, 0, 4, 398
"/Users/ali/cs5510/Group-Project-5510/RLU-Project-DEC7/RLU-Project/target/classes/rlu/benchmarks/jmh_generated/FineBSTBenchmark_g32for20_jmhTest.class", "Java", 0, 394, 0, 0, 4, 398
"/Users/ali/cs5510/Group-Project-5510/RLU-Project-DEC7/RLU-Project/target/classes/rlu/benchmarks/jmh_generated/FineBSTBenchmark_g32for40_jmhTest.class", "Java", 0, 394, 0, 0, 4, 398
"/Users/ali/cs5510/Group-Project-5510/RLU-Project-DEC7/RLU-Project/target/classes/rlu/benchmarks/jmh_generated/FineBSTBenchmark_g32for60_jmhTest.class", "Java", 0, 394, 0, 0, 4, 398
"/Users/ali/cs5510/Group-Project-5510/RLU-Project-DEC7/RLU-Project/target/classes/rlu/benchmarks/jmh_generated/FineBSTBenchmark_g32for80_jmhTest.class", "Java", 0, 394, 0, 0, 4, 398
"/Users/ali/cs5510/Group-Project-5510/RLU-Project-DEC7/RLU-Project/target/classes/rlu/benchmarks/jmh_generated/FineBSTBenchmark_g8for20_jmhTest.class", "Java", 0, 394, 0, 0, 4, 398
"/Users/ali/cs5510/Group-Project-5510/RLU-Project-DEC7/RLU-Project/target/classes/rlu/benchmarks/jmh_generated/FineBSTBenchmark_g8for40_jmhTest.class", "Java", 0, 394, 0, 0, 4, 398
"/Users/ali/cs5510/Group-Project-5510/RLU-Project-DEC7/RLU-Project/target/classes/rlu/benchmarks/jmh_generated/FineBSTBenchmark_g8for60_jmhTest.class", "Java", 0, 394, 0, 0, 4, 398
"/Users/ali/cs5510/Group-Project-5510/RLU-Project-DEC7/RLU-Project/target/classes/rlu/benchmarks/jmh_generated/FineBSTBenchmark_g8for80_jmhTest.class", "Java", 0, 394, 0, 0, 4, 398
"/Users/ali/cs5510/Group-Project-5510/RLU-Project-DEC7/RLU-Project/target/classes/rlu/benchmarks/jmh_generated/FineBSTBenchmark_jmhType.class", "Java", 0, 5, 0, 0, 0, 5
"/Users/ali/cs5510/Group-Project-5510/RLU-Project-DEC7/RLU-Project/target/classes/rlu/benchmarks/jmh_generated/FineBSTBenchmark_jmhType_B1.class", "Java", 0, 7, 0, 0, 0, 7
"/Users/ali/cs5510/Group-Project-5510/RLU-Project-DEC7/RLU-Project/target/classes/rlu/benchmarks/jmh_generated/FineBSTBenchmark_jmhType_B2.class", "Java", 0, 15, 0, 0, 0, 15
"/Users/ali/cs5510/Group-Project-5510/RLU-Project-DEC7/RLU-Project/target/classes/rlu/benchmarks/jmh_generated/FineBSTBenchmark_jmhType_B3.class", "Java", 0, 7, 0, 0, 0, 7
"/Users/ali/cs5510/Group-Project-5510/RLU-Project-DEC7/RLU-Project/target/classes/rlu/benchmarks/jmh_generated/FineSetBenchmark_MyState_jmhType.class", "Java", 0, 5, 0, 0, 0, 5
"/Users/ali/cs5510/Group-Project-5510/RLU-Project-DEC7/RLU-Project/target/classes/rlu/benchmarks/jmh_generated/FineSetBenchmark_MyState_jmhType_B1.class", "Java", 0, 8, 0, 0, 0, 8
"/Users/ali/cs5510/Group-Project-5510/RLU-Project-DEC7/RLU-Project/target/classes/rlu/benchmarks/jmh_generated/FineSetBenchmark_MyState_jmhType_B2.class", "Java", 0, 15, 0, 0, 0, 15
"/Users/ali/cs5510/Group-Project-5510/RLU-Project-DEC7/RLU-Project/target/classes/rlu/benchmarks/jmh_generated/FineSetBenchmark_MyState_jmhType_B3.class", "Java", 0, 7, 0, 0, 0, 7
"/Users/ali/cs5510/Group-Project-5510/RLU-Project-DEC7/RLU-Project/target/classes/rlu/benchmarks/jmh_generated/FineSetBenchmark_g16for20_jmhTest.class", "Java", 0, 397, 0, 0, 4, 401
"/Users/ali/cs5510/Group-Project-5510/RLU-Project-DEC7/RLU-Project/target/classes/rlu/benchmarks/jmh_generated/FineSetBenchmark_g16for40_jmhTest.class", "Java", 0, 397, 0, 0, 4, 401
"/Users/ali/cs5510/Group-Project-5510/RLU-Project-DEC7/RLU-Project/target/classes/rlu/benchmarks/jmh_generated/FineSetBenchmark_g16for60_jmhTest.class", "Java", 0, 397, 0, 0, 4, 401
"/Users/ali/cs5510/Group-Project-5510/RLU-Project-DEC7/RLU-Project/target/classes/rlu/benchmarks/jmh_generated/FineSetBenchmark_g16for80_jmhTest.class", "Java", 0, 397, 0, 0, 4, 401
"/Users/ali/cs5510/Group-Project-5510/RLU-Project-DEC7/RLU-Project/target/classes/rlu/benchmarks/jmh_generated/FineSetBenchmark_g24for20_jmhTest.class", "Java", 0, 397, 0, 0, 4, 401
"/Users/ali/cs5510/Group-Project-5510/RLU-Project-DEC7/RLU-Project/target/classes/rlu/benchmarks/jmh_generated/FineSetBenchmark_g24for40_jmhTest.class", "Java", 0, 397, 0, 0, 4, 401
"/Users/ali/cs5510/Group-Project-5510/RLU-Project-DEC7/RLU-Project/target/classes/rlu/benchmarks/jmh_generated/FineSetBenchmark_g24for60_jmhTest.class", "Java", 0, 397, 0, 0, 4, 401
"/Users/ali/cs5510/Group-Project-5510/RLU-Project-DEC7/RLU-Project/target/classes/rlu/benchmarks/jmh_generated/FineSetBenchmark_g24for80_jmhTest.class", "Java", 0, 397, 0, 0, 4, 401
"/Users/ali/cs5510/Group-Project-5510/RLU-Project-DEC7/RLU-Project/target/classes/rlu/benchmarks/jmh_generated/FineSetBenchmark_g32for20_jmhTest.class", "Java", 0, 397, 0, 0, 4, 401
"/Users/ali/cs5510/Group-Project-5510/RLU-Project-DEC7/RLU-Project/target/classes/rlu/benchmarks/jmh_generated/FineSetBenchmark_g32for40_jmhTest.class", "Java", 0, 397, 0, 0, 4, 401
"/Users/ali/cs5510/Group-Project-5510/RLU-Project-DEC7/RLU-Project/target/classes/rlu/benchmarks/jmh_generated/FineSetBenchmark_g32for60_jmhTest.class", "Java", 0, 397, 0, 0, 4, 401
"/Users/ali/cs5510/Group-Project-5510/RLU-Project-DEC7/RLU-Project/target/classes/rlu/benchmarks/jmh_generated/FineSetBenchmark_g32for80_jmhTest.class", "Java", 0, 397, 0, 0, 4, 401
"/Users/ali/cs5510/Group-Project-5510/RLU-Project-DEC7/RLU-Project/target/classes/rlu/benchmarks/jmh_generated/FineSetBenchmark_g8for20_jmhTest.class", "Java", 0, 397, 0, 0, 4, 401
"/Users/ali/cs5510/Group-Project-5510/RLU-Project-DEC7/RLU-Project/target/classes/rlu/benchmarks/jmh_generated/FineSetBenchmark_g8for40_jmhTest.class", "Java", 0, 397, 0, 0, 4, 401
"/Users/ali/cs5510/Group-Project-5510/RLU-Project-DEC7/RLU-Project/target/classes/rlu/benchmarks/jmh_generated/FineSetBenchmark_g8for60_jmhTest.class", "Java", 0, 397, 0, 0, 4, 401
"/Users/ali/cs5510/Group-Project-5510/RLU-Project-DEC7/RLU-Project/target/classes/rlu/benchmarks/jmh_generated/FineSetBenchmark_g8for80_jmhTest.class", "Java", 0, 397, 0, 0, 4, 401
"/Users/ali/cs5510/Group-Project-5510/RLU-Project-DEC7/RLU-Project/target/classes/rlu/benchmarks/jmh_generated/FineSetBenchmark_jmhType.class", "Java", 0, 5, 0, 0, 0, 5
"/Users/ali/cs5510/Group-Project-5510/RLU-Project-DEC7/RLU-Project/target/classes/rlu/benchmarks/jmh_generated/FineSetBenchmark_jmhType_B1.class", "Java", 0, 7, 0, 0, 0, 7
"/Users/ali/cs5510/Group-Project-5510/RLU-Project-DEC7/RLU-Project/target/classes/rlu/benchmarks/jmh_generated/FineSetBenchmark_jmhType_B2.class", "Java", 0, 15, 0, 0, 0, 15
"/Users/ali/cs5510/Group-Project-5510/RLU-Project-DEC7/RLU-Project/target/classes/rlu/benchmarks/jmh_generated/FineSetBenchmark_jmhType_B3.class", "Java", 0, 7, 0, 0, 0, 7
"/Users/ali/cs5510/Group-Project-5510/RLU-Project-DEC7/RLU-Project/target/classes/rlu/benchmarks/jmh_generated/LockFreeSetBenchmark_MyState_jmhType.class", "Java", 0, 5, 0, 0, 0, 5
"/Users/ali/cs5510/Group-Project-5510/RLU-Project-DEC7/RLU-Project/target/classes/rlu/benchmarks/jmh_generated/LockFreeSetBenchmark_MyState_jmhType_B1.class", "Java", 0, 8, 0, 0, 0, 8
"/Users/ali/cs5510/Group-Project-5510/RLU-Project-DEC7/RLU-Project/target/classes/rlu/benchmarks/jmh_generated/LockFreeSetBenchmark_MyState_jmhType_B2.class", "Java", 0, 15, 0, 0, 0, 15
"/Users/ali/cs5510/Group-Project-5510/RLU-Project-DEC7/RLU-Project/target/classes/rlu/benchmarks/jmh_generated/LockFreeSetBenchmark_MyState_jmhType_B3.class", "Java", 0, 7, 0, 0, 0, 7
"/Users/ali/cs5510/Group-Project-5510/RLU-Project-DEC7/RLU-Project/target/classes/rlu/benchmarks/jmh_generated/LockFreeSetBenchmark_g16for20_jmhTest.class", "Java", 0, 397, 0, 0, 4, 401
"/Users/ali/cs5510/Group-Project-5510/RLU-Project-DEC7/RLU-Project/target/classes/rlu/benchmarks/jmh_generated/LockFreeSetBenchmark_g16for40_jmhTest.class", "Java", 0, 397, 0, 0, 4, 401
"/Users/ali/cs5510/Group-Project-5510/RLU-Project-DEC7/RLU-Project/target/classes/rlu/benchmarks/jmh_generated/LockFreeSetBenchmark_g16for60_jmhTest.class", "Java", 0, 397, 0, 0, 4, 401
"/Users/ali/cs5510/Group-Project-5510/RLU-Project-DEC7/RLU-Project/target/classes/rlu/benchmarks/jmh_generated/LockFreeSetBenchmark_g16for80_jmhTest.class", "Java", 0, 397, 0, 0, 4, 401
"/Users/ali/cs5510/Group-Project-5510/RLU-Project-DEC7/RLU-Project/target/classes/rlu/benchmarks/jmh_generated/LockFreeSetBenchmark_g24for20_jmhTest.class", "Java", 0, 397, 0, 0, 4, 401
"/Users/ali/cs5510/Group-Project-5510/RLU-Project-DEC7/RLU-Project/target/classes/rlu/benchmarks/jmh_generated/LockFreeSetBenchmark_g24for40_jmhTest.class", "Java", 0, 397, 0, 0, 4, 401
"/Users/ali/cs5510/Group-Project-5510/RLU-Project-DEC7/RLU-Project/target/classes/rlu/benchmarks/jmh_generated/LockFreeSetBenchmark_g24for60_jmhTest.class", "Java", 0, 397, 0, 0, 4, 401
"/Users/ali/cs5510/Group-Project-5510/RLU-Project-DEC7/RLU-Project/target/classes/rlu/benchmarks/jmh_generated/LockFreeSetBenchmark_g24for80_jmhTest.class", "Java", 0, 397, 0, 0, 4, 401
"/Users/ali/cs5510/Group-Project-5510/RLU-Project-DEC7/RLU-Project/target/classes/rlu/benchmarks/jmh_generated/LockFreeSetBenchmark_g32for20_jmhTest.class", "Java", 0, 397, 0, 0, 4, 401
"/Users/ali/cs5510/Group-Project-5510/RLU-Project-DEC7/RLU-Project/target/classes/rlu/benchmarks/jmh_generated/LockFreeSetBenchmark_g32for40_jmhTest.class", "Java", 0, 397, 0, 0, 4, 401
"/Users/ali/cs5510/Group-Project-5510/RLU-Project-DEC7/RLU-Project/target/classes/rlu/benchmarks/jmh_generated/LockFreeSetBenchmark_g32for60_jmhTest.class", "Java", 0, 397, 0, 0, 4, 401
"/Users/ali/cs5510/Group-Project-5510/RLU-Project-DEC7/RLU-Project/target/classes/rlu/benchmarks/jmh_generated/LockFreeSetBenchmark_g32for80_jmhTest.class", "Java", 0, 397, 0, 0, 4, 401
"/Users/ali/cs5510/Group-Project-5510/RLU-Project-DEC7/RLU-Project/target/classes/rlu/benchmarks/jmh_generated/LockFreeSetBenchmark_g8for20_jmhTest.class", "Java", 0, 397, 0, 0, 4, 401
"/Users/ali/cs5510/Group-Project-5510/RLU-Project-DEC7/RLU-Project/target/classes/rlu/benchmarks/jmh_generated/LockFreeSetBenchmark_g8for40_jmhTest.class", "Java", 0, 397, 0, 0, 4, 401
"/Users/ali/cs5510/Group-Project-5510/RLU-Project-DEC7/RLU-Project/target/classes/rlu/benchmarks/jmh_generated/LockFreeSetBenchmark_g8for60_jmhTest.class", "Java", 0, 397, 0, 0, 4, 401
"/Users/ali/cs5510/Group-Project-5510/RLU-Project-DEC7/RLU-Project/target/classes/rlu/benchmarks/jmh_generated/LockFreeSetBenchmark_g8for80_jmhTest.class", "Java", 0, 397, 0, 0, 4, 401
"/Users/ali/cs5510/Group-Project-5510/RLU-Project-DEC7/RLU-Project/target/classes/rlu/benchmarks/jmh_generated/LockFreeSetBenchmark_jmhType.class", "Java", 0, 5, 0, 0, 0, 5
"/Users/ali/cs5510/Group-Project-5510/RLU-Project-DEC7/RLU-Project/target/classes/rlu/benchmarks/jmh_generated/LockFreeSetBenchmark_jmhType_B1.class", "Java", 0, 7, 0, 0, 0, 7
"/Users/ali/cs5510/Group-Project-5510/RLU-Project-DEC7/RLU-Project/target/classes/rlu/benchmarks/jmh_generated/LockFreeSetBenchmark_jmhType_B2.class", "Java", 0, 15, 0, 0, 0, 15
"/Users/ali/cs5510/Group-Project-5510/RLU-Project-DEC7/RLU-Project/target/classes/rlu/benchmarks/jmh_generated/LockFreeSetBenchmark_jmhType_B3.class", "Java", 0, 7, 0, 0, 0, 7
"/Users/ali/cs5510/Group-Project-5510/RLU-Project-DEC7/RLU-Project/target/classes/rlu/benchmarks/jmh_generated/RluCGPaddedSetBenchmark_GlobalState_jmhType.class", "Java", 0, 5, 0, 0, 0, 5
"/Users/ali/cs5510/Group-Project-5510/RLU-Project-DEC7/RLU-Project/target/classes/rlu/benchmarks/jmh_generated/RluCGPaddedSetBenchmark_GlobalState_jmhType_B1.class", "Java", 0, 8, 0, 0, 0, 8
"/Users/ali/cs5510/Group-Project-5510/RLU-Project-DEC7/RLU-Project/target/classes/rlu/benchmarks/jmh_generated/RluCGPaddedSetBenchmark_GlobalState_jmhType_B2.class", "Java", 0, 15, 0, 0, 0, 15
"/Users/ali/cs5510/Group-Project-5510/RLU-Project-DEC7/RLU-Project/target/classes/rlu/benchmarks/jmh_generated/RluCGPaddedSetBenchmark_GlobalState_jmhType_B3.class", "Java", 0, 7, 0, 0, 0, 7
"/Users/ali/cs5510/Group-Project-5510/RLU-Project-DEC7/RLU-Project/target/classes/rlu/benchmarks/jmh_generated/RluCGPaddedSetBenchmark_ThreadState_jmhType.class", "Java", 0, 5, 0, 0, 0, 5
"/Users/ali/cs5510/Group-Project-5510/RLU-Project-DEC7/RLU-Project/target/classes/rlu/benchmarks/jmh_generated/RluCGPaddedSetBenchmark_ThreadState_jmhType_B1.class", "Java", 0, 8, 0, 0, 0, 8
"/Users/ali/cs5510/Group-Project-5510/RLU-Project-DEC7/RLU-Project/target/classes/rlu/benchmarks/jmh_generated/RluCGPaddedSetBenchmark_ThreadState_jmhType_B2.class", "Java", 0, 14, 0, 0, 0, 14
"/Users/ali/cs5510/Group-Project-5510/RLU-Project-DEC7/RLU-Project/target/classes/rlu/benchmarks/jmh_generated/RluCGPaddedSetBenchmark_ThreadState_jmhType_B3.class", "Java", 0, 7, 0, 0, 0, 7
"/Users/ali/cs5510/Group-Project-5510/RLU-Project-DEC7/RLU-Project/target/classes/rlu/benchmarks/jmh_generated/RluCGPaddedSetBenchmark_g16for20_jmhTest.class", "Java", 0, 341, 0, 0, 0, 341
"/Users/ali/cs5510/Group-Project-5510/RLU-Project-DEC7/RLU-Project/target/classes/rlu/benchmarks/jmh_generated/RluCGPaddedSetBenchmark_g16for40_jmhTest.class", "Java", 0, 341, 0, 0, 0, 341
"/Users/ali/cs5510/Group-Project-5510/RLU-Project-DEC7/RLU-Project/target/classes/rlu/benchmarks/jmh_generated/RluCGPaddedSetBenchmark_g16for60_jmhTest.class", "Java", 0, 341, 0, 0, 0, 341
"/Users/ali/cs5510/Group-Project-5510/RLU-Project-DEC7/RLU-Project/target/classes/rlu/benchmarks/jmh_generated/RluCGPaddedSetBenchmark_g16for80_jmhTest.class", "Java", 0, 341, 0, 0, 0, 341
"/Users/ali/cs5510/Group-Project-5510/RLU-Project-DEC7/RLU-Project/target/classes/rlu/benchmarks/jmh_generated/RluCGPaddedSetBenchmark_g24for20_jmhTest.class", "Java", 0, 341, 0, 0, 0, 341
"/Users/ali/cs5510/Group-Project-5510/RLU-Project-DEC7/RLU-Project/target/classes/rlu/benchmarks/jmh_generated/RluCGPaddedSetBenchmark_g24for40_jmhTest.class", "Java", 0, 341, 0, 0, 0, 341
"/Users/ali/cs5510/Group-Project-5510/RLU-Project-DEC7/RLU-Project/target/classes/rlu/benchmarks/jmh_generated/RluCGPaddedSetBenchmark_g24for60_jmhTest.class", "Java", 0, 341, 0, 0, 0, 341
"/Users/ali/cs5510/Group-Project-5510/RLU-Project-DEC7/RLU-Project/target/classes/rlu/benchmarks/jmh_generated/RluCGPaddedSetBenchmark_g24for80_jmhTest.class", "Java", 0, 341, 0, 0, 0, 341
"/Users/ali/cs5510/Group-Project-5510/RLU-Project-DEC7/RLU-Project/target/classes/rlu/benchmarks/jmh_generated/RluCGPaddedSetBenchmark_g32for20_jmhTest.class", "Java", 0, 341, 0, 0, 0, 341
"/Users/ali/cs5510/Group-Project-5510/RLU-Project-DEC7/RLU-Project/target/classes/rlu/benchmarks/jmh_generated/RluCGPaddedSetBenchmark_g32for40_jmhTest.class", "Java", 0, 341, 0, 0, 0, 341
"/Users/ali/cs5510/Group-Project-5510/RLU-Project-DEC7/RLU-Project/target/classes/rlu/benchmarks/jmh_generated/RluCGPaddedSetBenchmark_g32for60_jmhTest.class", "Java", 0, 341, 0, 0, 0, 341
"/Users/ali/cs5510/Group-Project-5510/RLU-Project-DEC7/RLU-Project/target/classes/rlu/benchmarks/jmh_generated/RluCGPaddedSetBenchmark_g32for80_jmhTest.class", "Java", 0, 341, 0, 0, 0, 341
"/Users/ali/cs5510/Group-Project-5510/RLU-Project-DEC7/RLU-Project/target/classes/rlu/benchmarks/jmh_generated/RluCGPaddedSetBenchmark_g8for20_jmhTest.class", "Java", 0, 341, 0, 0, 0, 341
"/Users/ali/cs5510/Group-Project-5510/RLU-Project-DEC7/RLU-Project/target/classes/rlu/benchmarks/jmh_generated/RluCGPaddedSetBenchmark_g8for40_jmhTest.class", "Java", 0, 341, 0, 0, 0, 341
"/Users/ali/cs5510/Group-Project-5510/RLU-Project-DEC7/RLU-Project/target/classes/rlu/benchmarks/jmh_generated/RluCGPaddedSetBenchmark_g8for60_jmhTest.class", "Java", 0, 341, 0, 0, 0, 341
"/Users/ali/cs5510/Group-Project-5510/RLU-Project-DEC7/RLU-Project/target/classes/rlu/benchmarks/jmh_generated/RluCGPaddedSetBenchmark_g8for80_jmhTest.class", "Java", 0, 341, 0, 0, 0, 341
"/Users/ali/cs5510/Group-Project-5510/RLU-Project-DEC7/RLU-Project/target/classes/rlu/benchmarks/jmh_generated/RluCGPaddedSetBenchmark_jmhType.class", "Java", 0, 5, 0, 0, 0, 5
"/Users/ali/cs5510/Group-Project-5510/RLU-Project-DEC7/RLU-Project/target/classes/rlu/benchmarks/jmh_generated/RluCGPaddedSetBenchmark_jmhType_B1.class", "Java", 0, 7, 0, 0, 0, 7
"/Users/ali/cs5510/Group-Project-5510/RLU-Project-DEC7/RLU-Project/target/classes/rlu/benchmarks/jmh_generated/RluCGPaddedSetBenchmark_jmhType_B2.class", "Java", 0, 15, 0, 0, 0, 15
"/Users/ali/cs5510/Group-Project-5510/RLU-Project-DEC7/RLU-Project/target/classes/rlu/benchmarks/jmh_generated/RluCGPaddedSetBenchmark_jmhType_B3.class", "Java", 0, 7, 0, 0, 0, 7
"/Users/ali/cs5510/Group-Project-5510/RLU-Project-DEC7/RLU-Project/target/classes/rlu/benchmarks/jmh_generated/RluCGSetBenchmark_GlobalState_jmhType.class", "Java", 0, 5, 0, 0, 0, 5
"/Users/ali/cs5510/Group-Project-5510/RLU-Project-DEC7/RLU-Project/target/classes/rlu/benchmarks/jmh_generated/RluCGSetBenchmark_GlobalState_jmhType_B1.class", "Java", 0, 8, 0, 0, 0, 8
"/Users/ali/cs5510/Group-Project-5510/RLU-Project-DEC7/RLU-Project/target/classes/rlu/benchmarks/jmh_generated/RluCGSetBenchmark_GlobalState_jmhType_B2.class", "Java", 0, 15, 0, 0, 0, 15
"/Users/ali/cs5510/Group-Project-5510/RLU-Project-DEC7/RLU-Project/target/classes/rlu/benchmarks/jmh_generated/RluCGSetBenchmark_GlobalState_jmhType_B3.class", "Java", 0, 7, 0, 0, 0, 7
"/Users/ali/cs5510/Group-Project-5510/RLU-Project-DEC7/RLU-Project/target/classes/rlu/benchmarks/jmh_generated/RluCGSetBenchmark_ThreadState_jmhType.class", "Java", 0, 5, 0, 0, 0, 5
"/Users/ali/cs5510/Group-Project-5510/RLU-Project-DEC7/RLU-Project/target/classes/rlu/benchmarks/jmh_generated/RluCGSetBenchmark_ThreadState_jmhType_B1.class", "Java", 0, 8, 0, 0, 0, 8
"/Users/ali/cs5510/Group-Project-5510/RLU-Project-DEC7/RLU-Project/target/classes/rlu/benchmarks/jmh_generated/RluCGSetBenchmark_ThreadState_jmhType_B2.class", "Java", 0, 14, 0, 0, 0, 14
"/Users/ali/cs5510/Group-Project-5510/RLU-Project-DEC7/RLU-Project/target/classes/rlu/benchmarks/jmh_generated/RluCGSetBenchmark_ThreadState_jmhType_B3.class", "Java", 0, 7, 0, 0, 0, 7
"/Users/ali/cs5510/Group-Project-5510/RLU-Project-DEC7/RLU-Project/target/classes/rlu/benchmarks/jmh_generated/RluCGSetBenchmark_g16for20_jmhTest.class", "Java", 0, 341, 0, 0, 0, 341
"/Users/ali/cs5510/Group-Project-5510/RLU-Project-DEC7/RLU-Project/target/classes/rlu/benchmarks/jmh_generated/RluCGSetBenchmark_g16for40_jmhTest.class", "Java", 0, 341, 0, 0, 0, 341
"/Users/ali/cs5510/Group-Project-5510/RLU-Project-DEC7/RLU-Project/target/classes/rlu/benchmarks/jmh_generated/RluCGSetBenchmark_g16for60_jmhTest.class", "Java", 0, 341, 0, 0, 0, 341
"/Users/ali/cs5510/Group-Project-5510/RLU-Project-DEC7/RLU-Project/target/classes/rlu/benchmarks/jmh_generated/RluCGSetBenchmark_g16for80_jmhTest.class", "Java", 0, 341, 0, 0, 0, 341
"/Users/ali/cs5510/Group-Project-5510/RLU-Project-DEC7/RLU-Project/target/classes/rlu/benchmarks/jmh_generated/RluCGSetBenchmark_g24for20_jmhTest.class", "Java", 0, 341, 0, 0, 0, 341
"/Users/ali/cs5510/Group-Project-5510/RLU-Project-DEC7/RLU-Project/target/classes/rlu/benchmarks/jmh_generated/RluCGSetBenchmark_g24for40_jmhTest.class", "Java", 0, 341, 0, 0, 0, 341
"/Users/ali/cs5510/Group-Project-5510/RLU-Project-DEC7/RLU-Project/target/classes/rlu/benchmarks/jmh_generated/RluCGSetBenchmark_g24for60_jmhTest.class", "Java", 0, 341, 0, 0, 0, 341
"/Users/ali/cs5510/Group-Project-5510/RLU-Project-DEC7/RLU-Project/target/classes/rlu/benchmarks/jmh_generated/RluCGSetBenchmark_g24for80_jmhTest.class", "Java", 0, 341, 0, 0, 0, 341
"/Users/ali/cs5510/Group-Project-5510/RLU-Project-DEC7/RLU-Project/target/classes/rlu/benchmarks/jmh_generated/RluCGSetBenchmark_g32for20_jmhTest.class", "Java", 0, 341, 0, 0, 0, 341
"/Users/ali/cs5510/Group-Project-5510/RLU-Project-DEC7/RLU-Project/target/classes/rlu/benchmarks/jmh_generated/RluCGSetBenchmark_g32for40_jmhTest.class", "Java", 0, 341, 0, 0, 0, 341
"/Users/ali/cs5510/Group-Project-5510/RLU-Project-DEC7/RLU-Project/target/classes/rlu/benchmarks/jmh_generated/RluCGSetBenchmark_g32for60_jmhTest.class", "Java", 0, 341, 0, 0, 0, 341
"/Users/ali/cs5510/Group-Project-5510/RLU-Project-DEC7/RLU-Project/target/classes/rlu/benchmarks/jmh_generated/RluCGSetBenchmark_g32for80_jmhTest.class", "Java", 0, 341, 0, 0, 0, 341
"/Users/ali/cs5510/Group-Project-5510/RLU-Project-DEC7/RLU-Project/target/classes/rlu/benchmarks/jmh_generated/RluCGSetBenchmark_g8for20_jmhTest.class", "Java", 0, 341, 0, 0, 0, 341
"/Users/ali/cs5510/Group-Project-5510/RLU-Project-DEC7/RLU-Project/target/classes/rlu/benchmarks/jmh_generated/RluCGSetBenchmark_g8for40_jmhTest.class", "Java", 0, 341, 0, 0, 0, 341
"/Users/ali/cs5510/Group-Project-5510/RLU-Project-DEC7/RLU-Project/target/classes/rlu/benchmarks/jmh_generated/RluCGSetBenchmark_g8for60_jmhTest.class", "Java", 0, 341, 0, 0, 0, 341
"/Users/ali/cs5510/Group-Project-5510/RLU-Project-DEC7/RLU-Project/target/classes/rlu/benchmarks/jmh_generated/RluCGSetBenchmark_g8for80_jmhTest.class", "Java", 0, 341, 0, 0, 0, 341
"/Users/ali/cs5510/Group-Project-5510/RLU-Project-DEC7/RLU-Project/target/classes/rlu/benchmarks/jmh_generated/RluCGSetBenchmark_jmhType.class", "Java", 0, 5, 0, 0, 0, 5
"/Users/ali/cs5510/Group-Project-5510/RLU-Project-DEC7/RLU-Project/target/classes/rlu/benchmarks/jmh_generated/RluCGSetBenchmark_jmhType_B1.class", "Java", 0, 7, 0, 0, 0, 7
"/Users/ali/cs5510/Group-Project-5510/RLU-Project-DEC7/RLU-Project/target/classes/rlu/benchmarks/jmh_generated/RluCGSetBenchmark_jmhType_B2.class", "Java", 0, 15, 0, 0, 0, 15
"/Users/ali/cs5510/Group-Project-5510/RLU-Project-DEC7/RLU-Project/target/classes/rlu/benchmarks/jmh_generated/RluCGSetBenchmark_jmhType_B3.class", "Java", 0, 7, 0, 0, 0, 7
"/Users/ali/cs5510/Group-Project-5510/RLU-Project-DEC7/RLU-Project/target/classes/rlu/benchmarks/jmh_generated/RluCoarseBSTBenchmark_GlobalState_jmhType.class", "Java", 0, 5, 0, 0, 0, 5
"/Users/ali/cs5510/Group-Project-5510/RLU-Project-DEC7/RLU-Project/target/classes/rlu/benchmarks/jmh_generated/RluCoarseBSTBenchmark_GlobalState_jmhType_B1.class", "Java", 0, 8, 0, 0, 0, 8
"/Users/ali/cs5510/Group-Project-5510/RLU-Project-DEC7/RLU-Project/target/classes/rlu/benchmarks/jmh_generated/RluCoarseBSTBenchmark_GlobalState_jmhType_B2.class", "Java", 0, 15, 0, 0, 0, 15
"/Users/ali/cs5510/Group-Project-5510/RLU-Project-DEC7/RLU-Project/target/classes/rlu/benchmarks/jmh_generated/RluCoarseBSTBenchmark_GlobalState_jmhType_B3.class", "Java", 0, 7, 0, 0, 0, 7
"/Users/ali/cs5510/Group-Project-5510/RLU-Project-DEC7/RLU-Project/target/classes/rlu/benchmarks/jmh_generated/RluCoarseBSTBenchmark_ThreadState_jmhType.class", "Java", 0, 5, 0, 0, 0, 5
"/Users/ali/cs5510/Group-Project-5510/RLU-Project-DEC7/RLU-Project/target/classes/rlu/benchmarks/jmh_generated/RluCoarseBSTBenchmark_ThreadState_jmhType_B1.class", "Java", 0, 8, 0, 0, 0, 8
"/Users/ali/cs5510/Group-Project-5510/RLU-Project-DEC7/RLU-Project/target/classes/rlu/benchmarks/jmh_generated/RluCoarseBSTBenchmark_ThreadState_jmhType_B2.class", "Java", 0, 14, 0, 0, 0, 14
"/Users/ali/cs5510/Group-Project-5510/RLU-Project-DEC7/RLU-Project/target/classes/rlu/benchmarks/jmh_generated/RluCoarseBSTBenchmark_ThreadState_jmhType_B3.class", "Java", 0, 7, 0, 0, 0, 7
"/Users/ali/cs5510/Group-Project-5510/RLU-Project-DEC7/RLU-Project/target/classes/rlu/benchmarks/jmh_generated/RluCoarseBSTBenchmark_g16for20_jmhTest.class", "Java", 0, 341, 0, 0, 0, 341
"/Users/ali/cs5510/Group-Project-5510/RLU-Project-DEC7/RLU-Project/target/classes/rlu/benchmarks/jmh_generated/RluCoarseBSTBenchmark_g16for40_jmhTest.class", "Java", 0, 341, 0, 0, 0, 341
"/Users/ali/cs5510/Group-Project-5510/RLU-Project-DEC7/RLU-Project/target/classes/rlu/benchmarks/jmh_generated/RluCoarseBSTBenchmark_g16for60_jmhTest.class", "Java", 0, 341, 0, 0, 0, 341
"/Users/ali/cs5510/Group-Project-5510/RLU-Project-DEC7/RLU-Project/target/classes/rlu/benchmarks/jmh_generated/RluCoarseBSTBenchmark_g16for80_jmhTest.class", "Java", 0, 341, 0, 0, 0, 341
"/Users/ali/cs5510/Group-Project-5510/RLU-Project-DEC7/RLU-Project/target/classes/rlu/benchmarks/jmh_generated/RluCoarseBSTBenchmark_g24for20_jmhTest.class", "Java", 0, 341, 0, 0, 0, 341
"/Users/ali/cs5510/Group-Project-5510/RLU-Project-DEC7/RLU-Project/target/classes/rlu/benchmarks/jmh_generated/RluCoarseBSTBenchmark_g24for40_jmhTest.class", "Java", 0, 341, 0, 0, 0, 341
"/Users/ali/cs5510/Group-Project-5510/RLU-Project-DEC7/RLU-Project/target/classes/rlu/benchmarks/jmh_generated/RluCoarseBSTBenchmark_g24for60_jmhTest.class", "Java", 0, 341, 0, 0, 0, 341
"/Users/ali/cs5510/Group-Project-5510/RLU-Project-DEC7/RLU-Project/target/classes/rlu/benchmarks/jmh_generated/RluCoarseBSTBenchmark_g24for80_jmhTest.class", "Java", 0, 341, 0, 0, 0, 341
"/Users/ali/cs5510/Group-Project-5510/RLU-Project-DEC7/RLU-Project/target/classes/rlu/benchmarks/jmh_generated/RluCoarseBSTBenchmark_g32for20_jmhTest.class", "Java", 0, 341, 0, 0, 0, 341
"/Users/ali/cs5510/Group-Project-5510/RLU-Project-DEC7/RLU-Project/target/classes/rlu/benchmarks/jmh_generated/RluCoarseBSTBenchmark_g32for40_jmhTest.class", "Java", 0, 341, 0, 0, 0, 341
"/Users/ali/cs5510/Group-Project-5510/RLU-Project-DEC7/RLU-Project/target/classes/rlu/benchmarks/jmh_generated/RluCoarseBSTBenchmark_g32for60_jmhTest.class", "Java", 0, 341, 0, 0, 0, 341
"/Users/ali/cs5510/Group-Project-5510/RLU-Project-DEC7/RLU-Project/target/classes/rlu/benchmarks/jmh_generated/RluCoarseBSTBenchmark_g32for80_jmhTest.class", "Java", 0, 341, 0, 0, 0, 341
"/Users/ali/cs5510/Group-Project-5510/RLU-Project-DEC7/RLU-Project/target/classes/rlu/benchmarks/jmh_generated/RluCoarseBSTBenchmark_g8for20_jmhTest.class", "Java", 0, 341, 0, 0, 0, 341
"/Users/ali/cs5510/Group-Project-5510/RLU-Project-DEC7/RLU-Project/target/classes/rlu/benchmarks/jmh_generated/RluCoarseBSTBenchmark_g8for40_jmhTest.class", "Java", 0, 341, 0, 0, 0, 341
"/Users/ali/cs5510/Group-Project-5510/RLU-Project-DEC7/RLU-Project/target/classes/rlu/benchmarks/jmh_generated/RluCoarseBSTBenchmark_g8for60_jmhTest.class", "Java", 0, 341, 0, 0, 0, 341
"/Users/ali/cs5510/Group-Project-5510/RLU-Project-DEC7/RLU-Project/target/classes/rlu/benchmarks/jmh_generated/RluCoarseBSTBenchmark_g8for80_jmhTest.class", "Java", 0, 341, 0, 0, 0, 341
"/Users/ali/cs5510/Group-Project-5510/RLU-Project-DEC7/RLU-Project/target/classes/rlu/benchmarks/jmh_generated/RluCoarseBSTBenchmark_jmhType.class", "Java", 0, 5, 0, 0, 0, 5
"/Users/ali/cs5510/Group-Project-5510/RLU-Project-DEC7/RLU-Project/target/classes/rlu/benchmarks/jmh_generated/RluCoarseBSTBenchmark_jmhType_B1.class", "Java", 0, 7, 0, 0, 0, 7
"/Users/ali/cs5510/Group-Project-5510/RLU-Project-DEC7/RLU-Project/target/classes/rlu/benchmarks/jmh_generated/RluCoarseBSTBenchmark_jmhType_B2.class", "Java", 0, 15, 0, 0, 0, 15
"/Users/ali/cs5510/Group-Project-5510/RLU-Project-DEC7/RLU-Project/target/classes/rlu/benchmarks/jmh_generated/RluCoarseBSTBenchmark_jmhType_B3.class", "Java", 0, 7, 0, 0, 0, 7
"/Users/ali/cs5510/Group-Project-5510/RLU-Project-DEC7/RLU-Project/target/classes/rlu/benchmarks/jmh_generated/RluFGSetBenchmark_GlobalState_jmhType.class", "Java", 0, 5, 0, 0, 0, 5
"/Users/ali/cs5510/Group-Project-5510/RLU-Project-DEC7/RLU-Project/target/classes/rlu/benchmarks/jmh_generated/RluFGSetBenchmark_GlobalState_jmhType_B1.class", "Java", 0, 8, 0, 0, 0, 8
"/Users/ali/cs5510/Group-Project-5510/RLU-Project-DEC7/RLU-Project/target/classes/rlu/benchmarks/jmh_generated/RluFGSetBenchmark_GlobalState_jmhType_B2.class", "Java", 0, 15, 0, 0, 0, 15
"/Users/ali/cs5510/Group-Project-5510/RLU-Project-DEC7/RLU-Project/target/classes/rlu/benchmarks/jmh_generated/RluFGSetBenchmark_GlobalState_jmhType_B3.class", "Java", 0, 7, 0, 0, 0, 7
"/Users/ali/cs5510/Group-Project-5510/RLU-Project-DEC7/RLU-Project/target/classes/rlu/benchmarks/jmh_generated/RluFGSetBenchmark_ThreadState_jmhType.class", "Java", 0, 5, 0, 0, 0, 5
"/Users/ali/cs5510/Group-Project-5510/RLU-Project-DEC7/RLU-Project/target/classes/rlu/benchmarks/jmh_generated/RluFGSetBenchmark_ThreadState_jmhType_B1.class", "Java", 0, 8, 0, 0, 0, 8
"/Users/ali/cs5510/Group-Project-5510/RLU-Project-DEC7/RLU-Project/target/classes/rlu/benchmarks/jmh_generated/RluFGSetBenchmark_ThreadState_jmhType_B2.class", "Java", 0, 14, 0, 0, 0, 14
"/Users/ali/cs5510/Group-Project-5510/RLU-Project-DEC7/RLU-Project/target/classes/rlu/benchmarks/jmh_generated/RluFGSetBenchmark_ThreadState_jmhType_B3.class", "Java", 0, 7, 0, 0, 0, 7
"/Users/ali/cs5510/Group-Project-5510/RLU-Project-DEC7/RLU-Project/target/classes/rlu/benchmarks/jmh_generated/RluFGSetBenchmark_g16for20_jmhTest.class", "Java", 0, 341, 0, 0, 0, 341
"/Users/ali/cs5510/Group-Project-5510/RLU-Project-DEC7/RLU-Project/target/classes/rlu/benchmarks/jmh_generated/RluFGSetBenchmark_g16for40_jmhTest.class", "Java", 0, 341, 0, 0, 0, 341
"/Users/ali/cs5510/Group-Project-5510/RLU-Project-DEC7/RLU-Project/target/classes/rlu/benchmarks/jmh_generated/RluFGSetBenchmark_g16for60_jmhTest.class", "Java", 0, 341, 0, 0, 0, 341
"/Users/ali/cs5510/Group-Project-5510/RLU-Project-DEC7/RLU-Project/target/classes/rlu/benchmarks/jmh_generated/RluFGSetBenchmark_g16for80_jmhTest.class", "Java", 0, 341, 0, 0, 0, 341
"/Users/ali/cs5510/Group-Project-5510/RLU-Project-DEC7/RLU-Project/target/classes/rlu/benchmarks/jmh_generated/RluFGSetBenchmark_g24for20_jmhTest.class", "Java", 0, 341, 0, 0, 0, 341
"/Users/ali/cs5510/Group-Project-5510/RLU-Project-DEC7/RLU-Project/target/classes/rlu/benchmarks/jmh_generated/RluFGSetBenchmark_g24for40_jmhTest.class", "Java", 0, 341, 0, 0, 0, 341
"/Users/ali/cs5510/Group-Project-5510/RLU-Project-DEC7/RLU-Project/target/classes/rlu/benchmarks/jmh_generated/RluFGSetBenchmark_g24for60_jmhTest.class", "Java", 0, 341, 0, 0, 0, 341
"/Users/ali/cs5510/Group-Project-5510/RLU-Project-DEC7/RLU-Project/target/classes/rlu/benchmarks/jmh_generated/RluFGSetBenchmark_g24for80_jmhTest.class", "Java", 0, 341, 0, 0, 0, 341
"/Users/ali/cs5510/Group-Project-5510/RLU-Project-DEC7/RLU-Project/target/classes/rlu/benchmarks/jmh_generated/RluFGSetBenchmark_g32for20_jmhTest.class", "Java", 0, 341, 0, 0, 0, 341
"/Users/ali/cs5510/Group-Project-5510/RLU-Project-DEC7/RLU-Project/target/classes/rlu/benchmarks/jmh_generated/RluFGSetBenchmark_g32for40_jmhTest.class", "Java", 0, 341, 0, 0, 0, 341
"/Users/ali/cs5510/Group-Project-5510/RLU-Project-DEC7/RLU-Project/target/classes/rlu/benchmarks/jmh_generated/RluFGSetBenchmark_g32for60_jmhTest.class", "Java", 0, 341, 0, 0, 0, 341
"/Users/ali/cs5510/Group-Project-5510/RLU-Project-DEC7/RLU-Project/target/classes/rlu/benchmarks/jmh_generated/RluFGSetBenchmark_g32for80_jmhTest.class", "Java", 0, 341, 0, 0, 0, 341
"/Users/ali/cs5510/Group-Project-5510/RLU-Project-DEC7/RLU-Project/target/classes/rlu/benchmarks/jmh_generated/RluFGSetBenchmark_g8for20_jmhTest.class", "Java", 0, 341, 0, 0, 0, 341
"/Users/ali/cs5510/Group-Project-5510/RLU-Project-DEC7/RLU-Project/target/classes/rlu/benchmarks/jmh_generated/RluFGSetBenchmark_g8for40_jmhTest.class", "Java", 0, 341, 0, 0, 0, 341
"/Users/ali/cs5510/Group-Project-5510/RLU-Project-DEC7/RLU-Project/target/classes/rlu/benchmarks/jmh_generated/RluFGSetBenchmark_g8for60_jmhTest.class", "Java", 0, 341, 0, 0, 0, 341
"/Users/ali/cs5510/Group-Project-5510/RLU-Project-DEC7/RLU-Project/target/classes/rlu/benchmarks/jmh_generated/RluFGSetBenchmark_g8for80_jmhTest.class", "Java", 0, 341, 0, 0, 0, 341
"/Users/ali/cs5510/Group-Project-5510/RLU-Project-DEC7/RLU-Project/target/classes/rlu/benchmarks/jmh_generated/RluFGSetBenchmark_jmhType.class", "Java", 0, 5, 0, 0, 0, 5
"/Users/ali/cs5510/Group-Project-5510/RLU-Project-DEC7/RLU-Project/target/classes/rlu/benchmarks/jmh_generated/RluFGSetBenchmark_jmhType_B1.class", "Java", 0, 7, 0, 0, 0, 7
"/Users/ali/cs5510/Group-Project-5510/RLU-Project-DEC7/RLU-Project/target/classes/rlu/benchmarks/jmh_generated/RluFGSetBenchmark_jmhType_B2.class", "Java", 0, 15, 0, 0, 0, 15
"/Users/ali/cs5510/Group-Project-5510/RLU-Project-DEC7/RLU-Project/target/classes/rlu/benchmarks/jmh_generated/RluFGSetBenchmark_jmhType_B3.class", "Java", 0, 7, 0, 0, 0, 7
"/Users/ali/cs5510/Group-Project-5510/RLU-Project-DEC7/RLU-Project/target/classes/rlu/benchmarks/jmh_generated/RluFineBSTBenchmark_GlobalState_jmhType.class", "Java", 0, 5, 0, 0, 0, 5
"/Users/ali/cs5510/Group-Project-5510/RLU-Project-DEC7/RLU-Project/target/classes/rlu/benchmarks/jmh_generated/RluFineBSTBenchmark_GlobalState_jmhType_B1.class", "Java", 0, 8, 0, 0, 0, 8
"/Users/ali/cs5510/Group-Project-5510/RLU-Project-DEC7/RLU-Project/target/classes/rlu/benchmarks/jmh_generated/RluFineBSTBenchmark_GlobalState_jmhType_B2.class", "Java", 0, 15, 0, 0, 0, 15
"/Users/ali/cs5510/Group-Project-5510/RLU-Project-DEC7/RLU-Project/target/classes/rlu/benchmarks/jmh_generated/RluFineBSTBenchmark_GlobalState_jmhType_B3.class", "Java", 0, 7, 0, 0, 0, 7
"/Users/ali/cs5510/Group-Project-5510/RLU-Project-DEC7/RLU-Project/target/classes/rlu/benchmarks/jmh_generated/RluFineBSTBenchmark_ThreadState_jmhType.class", "Java", 0, 5, 0, 0, 0, 5
"/Users/ali/cs5510/Group-Project-5510/RLU-Project-DEC7/RLU-Project/target/classes/rlu/benchmarks/jmh_generated/RluFineBSTBenchmark_ThreadState_jmhType_B1.class", "Java", 0, 8, 0, 0, 0, 8
"/Users/ali/cs5510/Group-Project-5510/RLU-Project-DEC7/RLU-Project/target/classes/rlu/benchmarks/jmh_generated/RluFineBSTBenchmark_ThreadState_jmhType_B2.class", "Java", 0, 14, 0, 0, 0, 14
"/Users/ali/cs5510/Group-Project-5510/RLU-Project-DEC7/RLU-Project/target/classes/rlu/benchmarks/jmh_generated/RluFineBSTBenchmark_ThreadState_jmhType_B3.class", "Java", 0, 7, 0, 0, 0, 7
"/Users/ali/cs5510/Group-Project-5510/RLU-Project-DEC7/RLU-Project/target/classes/rlu/benchmarks/jmh_generated/RluFineBSTBenchmark_g16for20_jmhTest.class", "Java", 0, 341, 0, 0, 0, 341
"/Users/ali/cs5510/Group-Project-5510/RLU-Project-DEC7/RLU-Project/target/classes/rlu/benchmarks/jmh_generated/RluFineBSTBenchmark_g16for40_jmhTest.class", "Java", 0, 341, 0, 0, 0, 341
"/Users/ali/cs5510/Group-Project-5510/RLU-Project-DEC7/RLU-Project/target/classes/rlu/benchmarks/jmh_generated/RluFineBSTBenchmark_g16for60_jmhTest.class", "Java", 0, 341, 0, 0, 0, 341
"/Users/ali/cs5510/Group-Project-5510/RLU-Project-DEC7/RLU-Project/target/classes/rlu/benchmarks/jmh_generated/RluFineBSTBenchmark_g16for80_jmhTest.class", "Java", 0, 341, 0, 0, 0, 341
"/Users/ali/cs5510/Group-Project-5510/RLU-Project-DEC7/RLU-Project/target/classes/rlu/benchmarks/jmh_generated/RluFineBSTBenchmark_g24for20_jmhTest.class", "Java", 0, 341, 0, 0, 0, 341
"/Users/ali/cs5510/Group-Project-5510/RLU-Project-DEC7/RLU-Project/target/classes/rlu/benchmarks/jmh_generated/RluFineBSTBenchmark_g24for40_jmhTest.class", "Java", 0, 341, 0, 0, 0, 341
"/Users/ali/cs5510/Group-Project-5510/RLU-Project-DEC7/RLU-Project/target/classes/rlu/benchmarks/jmh_generated/RluFineBSTBenchmark_g24for60_jmhTest.class", "Java", 0, 341, 0, 0, 0, 341
"/Users/ali/cs5510/Group-Project-5510/RLU-Project-DEC7/RLU-Project/target/classes/rlu/benchmarks/jmh_generated/RluFineBSTBenchmark_g24for80_jmhTest.class", "Java", 0, 341, 0, 0, 0, 341
"/Users/ali/cs5510/Group-Project-5510/RLU-Project-DEC7/RLU-Project/target/classes/rlu/benchmarks/jmh_generated/RluFineBSTBenchmark_g32for20_jmhTest.class", "Java", 0, 341, 0, 0, 0, 341
"/Users/ali/cs5510/Group-Project-5510/RLU-Project-DEC7/RLU-Project/target/classes/rlu/benchmarks/jmh_generated/RluFineBSTBenchmark_g32for40_jmhTest.class", "Java", 0, 341, 0, 0, 0, 341
"/Users/ali/cs5510/Group-Project-5510/RLU-Project-DEC7/RLU-Project/target/classes/rlu/benchmarks/jmh_generated/RluFineBSTBenchmark_g32for60_jmhTest.class", "Java", 0, 341, 0, 0, 0, 341
"/Users/ali/cs5510/Group-Project-5510/RLU-Project-DEC7/RLU-Project/target/classes/rlu/benchmarks/jmh_generated/RluFineBSTBenchmark_g32for80_jmhTest.class", "Java", 0, 341, 0, 0, 0, 341
"/Users/ali/cs5510/Group-Project-5510/RLU-Project-DEC7/RLU-Project/target/classes/rlu/benchmarks/jmh_generated/RluFineBSTBenchmark_g8for20_jmhTest.class", "Java", 0, 341, 0, 0, 0, 341
"/Users/ali/cs5510/Group-Project-5510/RLU-Project-DEC7/RLU-Project/target/classes/rlu/benchmarks/jmh_generated/RluFineBSTBenchmark_g8for40_jmhTest.class", "Java", 0, 341, 0, 0, 0, 341
"/Users/ali/cs5510/Group-Project-5510/RLU-Project-DEC7/RLU-Project/target/classes/rlu/benchmarks/jmh_generated/RluFineBSTBenchmark_g8for60_jmhTest.class", "Java", 0, 341, 0, 0, 0, 341
"/Users/ali/cs5510/Group-Project-5510/RLU-Project-DEC7/RLU-Project/target/classes/rlu/benchmarks/jmh_generated/RluFineBSTBenchmark_g8for80_jmhTest.class", "Java", 0, 341, 0, 0, 0, 341
"/Users/ali/cs5510/Group-Project-5510/RLU-Project-DEC7/RLU-Project/target/classes/rlu/benchmarks/jmh_generated/RluFineBSTBenchmark_jmhType.class", "Java", 0, 5, 0, 0, 0, 5
"/Users/ali/cs5510/Group-Project-5510/RLU-Project-DEC7/RLU-Project/target/classes/rlu/benchmarks/jmh_generated/RluFineBSTBenchmark_jmhType_B1.class", "Java", 0, 7, 0, 0, 0, 7
"/Users/ali/cs5510/Group-Project-5510/RLU-Project-DEC7/RLU-Project/target/classes/rlu/benchmarks/jmh_generated/RluFineBSTBenchmark_jmhType_B2.class", "Java", 0, 15, 0, 0, 0, 15
"/Users/ali/cs5510/Group-Project-5510/RLU-Project-DEC7/RLU-Project/target/classes/rlu/benchmarks/jmh_generated/RluFineBSTBenchmark_jmhType_B3.class", "Java", 0, 7, 0, 0, 0, 7
"/Users/ali/cs5510/Group-Project-5510/RLU-Project-DEC7/RLU-Project/target/classes/rlu/benchmarks/jmh_generated/RluMultiObjectSetBenchmark_GlobalState_jmhType.class", "Java", 0, 5, 0, 0, 0, 5
"/Users/ali/cs5510/Group-Project-5510/RLU-Project-DEC7/RLU-Project/target/classes/rlu/benchmarks/jmh_generated/RluMultiObjectSetBenchmark_GlobalState_jmhType_B1.class", "Java", 0, 8, 0, 0, 0, 8
"/Users/ali/cs5510/Group-Project-5510/RLU-Project-DEC7/RLU-Project/target/classes/rlu/benchmarks/jmh_generated/RluMultiObjectSetBenchmark_GlobalState_jmhType_B2.class", "Java", 0, 15, 0, 0, 0, 15
"/Users/ali/cs5510/Group-Project-5510/RLU-Project-DEC7/RLU-Project/target/classes/rlu/benchmarks/jmh_generated/RluMultiObjectSetBenchmark_GlobalState_jmhType_B3.class", "Java", 0, 7, 0, 0, 0, 7
"/Users/ali/cs5510/Group-Project-5510/RLU-Project-DEC7/RLU-Project/target/classes/rlu/benchmarks/jmh_generated/RluMultiObjectSetBenchmark_ThreadState_jmhType.class", "Java", 0, 5, 0, 0, 0, 5
"/Users/ali/cs5510/Group-Project-5510/RLU-Project-DEC7/RLU-Project/target/classes/rlu/benchmarks/jmh_generated/RluMultiObjectSetBenchmark_ThreadState_jmhType_B1.class", "Java", 0, 8, 0, 0, 0, 8
"/Users/ali/cs5510/Group-Project-5510/RLU-Project-DEC7/RLU-Project/target/classes/rlu/benchmarks/jmh_generated/RluMultiObjectSetBenchmark_ThreadState_jmhType_B2.class", "Java", 0, 14, 0, 0, 0, 14
"/Users/ali/cs5510/Group-Project-5510/RLU-Project-DEC7/RLU-Project/target/classes/rlu/benchmarks/jmh_generated/RluMultiObjectSetBenchmark_ThreadState_jmhType_B3.class", "Java", 0, 7, 0, 0, 0, 7
"/Users/ali/cs5510/Group-Project-5510/RLU-Project-DEC7/RLU-Project/target/classes/rlu/benchmarks/jmh_generated/RluMultiObjectSetBenchmark_g16for20_jmhTest.class", "Java", 0, 341, 0, 0, 0, 341
"/Users/ali/cs5510/Group-Project-5510/RLU-Project-DEC7/RLU-Project/target/classes/rlu/benchmarks/jmh_generated/RluMultiObjectSetBenchmark_g16for40_jmhTest.class", "Java", 0, 341, 0, 0, 0, 341
"/Users/ali/cs5510/Group-Project-5510/RLU-Project-DEC7/RLU-Project/target/classes/rlu/benchmarks/jmh_generated/RluMultiObjectSetBenchmark_g16for60_jmhTest.class", "Java", 0, 341, 0, 0, 0, 341
"/Users/ali/cs5510/Group-Project-5510/RLU-Project-DEC7/RLU-Project/target/classes/rlu/benchmarks/jmh_generated/RluMultiObjectSetBenchmark_g16for80_jmhTest.class", "Java", 0, 341, 0, 0, 0, 341
"/Users/ali/cs5510/Group-Project-5510/RLU-Project-DEC7/RLU-Project/target/classes/rlu/benchmarks/jmh_generated/RluMultiObjectSetBenchmark_g24for20_jmhTest.class", "Java", 0, 341, 0, 0, 0, 341
"/Users/ali/cs5510/Group-Project-5510/RLU-Project-DEC7/RLU-Project/target/classes/rlu/benchmarks/jmh_generated/RluMultiObjectSetBenchmark_g24for40_jmhTest.class", "Java", 0, 341, 0, 0, 0, 341
"/Users/ali/cs5510/Group-Project-5510/RLU-Project-DEC7/RLU-Project/target/classes/rlu/benchmarks/jmh_generated/RluMultiObjectSetBenchmark_g24for60_jmhTest.class", "Java", 0, 341, 0, 0, 0, 341
"/Users/ali/cs5510/Group-Project-5510/RLU-Project-DEC7/RLU-Project/target/classes/rlu/benchmarks/jmh_generated/RluMultiObjectSetBenchmark_g24for80_jmhTest.class", "Java", 0, 341, 0, 0, 0, 341
"/Users/ali/cs5510/Group-Project-5510/RLU-Project-DEC7/RLU-Project/target/classes/rlu/benchmarks/jmh_generated/RluMultiObjectSetBenchmark_g32for20_jmhTest.class", "Java", 0, 341, 0, 0, 0, 341
"/Users/ali/cs5510/Group-Project-5510/RLU-Project-DEC7/RLU-Project/target/classes/rlu/benchmarks/jmh_generated/RluMultiObjectSetBenchmark_g32for40_jmhTest.class", "Java", 0, 341, 0, 0, 0, 341
"/Users/ali/cs5510/Group-Project-5510/RLU-Project-DEC7/RLU-Project/target/classes/rlu/benchmarks/jmh_generated/RluMultiObjectSetBenchmark_g32for60_jmhTest.class", "Java", 0, 341, 0, 0, 0, 341
"/Users/ali/cs5510/Group-Project-5510/RLU-Project-DEC7/RLU-Project/target/classes/rlu/benchmarks/jmh_generated/RluMultiObjectSetBenchmark_g32for80_jmhTest.class", "Java", 0, 341, 0, 0, 0, 341
"/Users/ali/cs5510/Group-Project-5510/RLU-Project-DEC7/RLU-Project/target/classes/rlu/benchmarks/jmh_generated/RluMultiObjectSetBenchmark_g8for20_jmhTest.class", "Java", 0, 341, 0, 0, 0, 341
"/Users/ali/cs5510/Group-Project-5510/RLU-Project-DEC7/RLU-Project/target/classes/rlu/benchmarks/jmh_generated/RluMultiObjectSetBenchmark_g8for40_jmhTest.class", "Java", 0, 341, 0, 0, 0, 341
"/Users/ali/cs5510/Group-Project-5510/RLU-Project-DEC7/RLU-Project/target/classes/rlu/benchmarks/jmh_generated/RluMultiObjectSetBenchmark_g8for60_jmhTest.class", "Java", 0, 341, 0, 0, 0, 341
"/Users/ali/cs5510/Group-Project-5510/RLU-Project-DEC7/RLU-Project/target/classes/rlu/benchmarks/jmh_generated/RluMultiObjectSetBenchmark_g8for80_jmhTest.class", "Java", 0, 341, 0, 0, 0, 341
"/Users/ali/cs5510/Group-Project-5510/RLU-Project-DEC7/RLU-Project/target/classes/rlu/benchmarks/jmh_generated/RluMultiObjectSetBenchmark_jmhType.class", "Java", 0, 5, 0, 0, 0, 5
"/Users/ali/cs5510/Group-Project-5510/RLU-Project-DEC7/RLU-Project/target/classes/rlu/benchmarks/jmh_generated/RluMultiObjectSetBenchmark_jmhType_B1.class", "Java", 0, 7, 0, 0, 0, 7
"/Users/ali/cs5510/Group-Project-5510/RLU-Project-DEC7/RLU-Project/target/classes/rlu/benchmarks/jmh_generated/RluMultiObjectSetBenchmark_jmhType_B2.class", "Java", 0, 15, 0, 0, 0, 15
"/Users/ali/cs5510/Group-Project-5510/RLU-Project-DEC7/RLU-Project/target/classes/rlu/benchmarks/jmh_generated/RluMultiObjectSetBenchmark_jmhType_B3.class", "Java", 0, 7, 0, 0, 0, 7
"/Users/ali/cs5510/Group-Project-5510/RLU-Project-DEC7/RLU-Project/target/classes/rlu/benchmarks/jmh_generated/URCUCGSetBenchmark_GlobalState_jmhType.class", "Java", 0, 5, 0, 0, 0, 5
"/Users/ali/cs5510/Group-Project-5510/RLU-Project-DEC7/RLU-Project/target/classes/rlu/benchmarks/jmh_generated/URCUCGSetBenchmark_GlobalState_jmhType_B1.class", "Java", 0, 8, 0, 0, 0, 8
"/Users/ali/cs5510/Group-Project-5510/RLU-Project-DEC7/RLU-Project/target/classes/rlu/benchmarks/jmh_generated/URCUCGSetBenchmark_GlobalState_jmhType_B2.class", "Java", 0, 15, 0, 0, 0, 15
"/Users/ali/cs5510/Group-Project-5510/RLU-Project-DEC7/RLU-Project/target/classes/rlu/benchmarks/jmh_generated/URCUCGSetBenchmark_GlobalState_jmhType_B3.class", "Java", 0, 7, 0, 0, 0, 7
"/Users/ali/cs5510/Group-Project-5510/RLU-Project-DEC7/RLU-Project/target/classes/rlu/benchmarks/jmh_generated/URCUCGSetBenchmark_ThreadState_jmhType.class", "Java", 0, 5, 0, 0, 0, 5
"/Users/ali/cs5510/Group-Project-5510/RLU-Project-DEC7/RLU-Project/target/classes/rlu/benchmarks/jmh_generated/URCUCGSetBenchmark_ThreadState_jmhType_B1.class", "Java", 0, 8, 0, 0, 0, 8
"/Users/ali/cs5510/Group-Project-5510/RLU-Project-DEC7/RLU-Project/target/classes/rlu/benchmarks/jmh_generated/URCUCGSetBenchmark_ThreadState_jmhType_B2.class", "Java", 0, 14, 0, 0, 0, 14
"/Users/ali/cs5510/Group-Project-5510/RLU-Project-DEC7/RLU-Project/target/classes/rlu/benchmarks/jmh_generated/URCUCGSetBenchmark_ThreadState_jmhType_B3.class", "Java", 0, 7, 0, 0, 0, 7
"/Users/ali/cs5510/Group-Project-5510/RLU-Project-DEC7/RLU-Project/target/classes/rlu/benchmarks/jmh_generated/URCUCGSetBenchmark_g16for20_jmhTest.class", "Java", 0, 341, 0, 0, 0, 341
"/Users/ali/cs5510/Group-Project-5510/RLU-Project-DEC7/RLU-Project/target/classes/rlu/benchmarks/jmh_generated/URCUCGSetBenchmark_g16for40_jmhTest.class", "Java", 0, 341, 0, 0, 0, 341
"/Users/ali/cs5510/Group-Project-5510/RLU-Project-DEC7/RLU-Project/target/classes/rlu/benchmarks/jmh_generated/URCUCGSetBenchmark_g16for60_jmhTest.class", "Java", 0, 341, 0, 0, 0, 341
"/Users/ali/cs5510/Group-Project-5510/RLU-Project-DEC7/RLU-Project/target/classes/rlu/benchmarks/jmh_generated/URCUCGSetBenchmark_g16for80_jmhTest.class", "Java", 0, 341, 0, 0, 0, 341
"/Users/ali/cs5510/Group-Project-5510/RLU-Project-DEC7/RLU-Project/target/classes/rlu/benchmarks/jmh_generated/URCUCGSetBenchmark_g24for20_jmhTest.class", "Java", 0, 341, 0, 0, 0, 341
"/Users/ali/cs5510/Group-Project-5510/RLU-Project-DEC7/RLU-Project/target/classes/rlu/benchmarks/jmh_generated/URCUCGSetBenchmark_g24for40_jmhTest.class", "Java", 0, 341, 0, 0, 0, 341
"/Users/ali/cs5510/Group-Project-5510/RLU-Project-DEC7/RLU-Project/target/classes/rlu/benchmarks/jmh_generated/URCUCGSetBenchmark_g24for60_jmhTest.class", "Java", 0, 341, 0, 0, 0, 341
"/Users/ali/cs5510/Group-Project-5510/RLU-Project-DEC7/RLU-Project/target/classes/rlu/benchmarks/jmh_generated/URCUCGSetBenchmark_g24for80_jmhTest.class", "Java", 0, 341, 0, 0, 0, 341
"/Users/ali/cs5510/Group-Project-5510/RLU-Project-DEC7/RLU-Project/target/classes/rlu/benchmarks/jmh_generated/URCUCGSetBenchmark_g32for20_jmhTest.class", "Java", 0, 341, 0, 0, 0, 341
"/Users/ali/cs5510/Group-Project-5510/RLU-Project-DEC7/RLU-Project/target/classes/rlu/benchmarks/jmh_generated/URCUCGSetBenchmark_g32for40_jmhTest.class", "Java", 0, 341, 0, 0, 0, 341
"/Users/ali/cs5510/Group-Project-5510/RLU-Project-DEC7/RLU-Project/target/classes/rlu/benchmarks/jmh_generated/URCUCGSetBenchmark_g32for60_jmhTest.class", "Java", 0, 341, 0, 0, 0, 341
"/Users/ali/cs5510/Group-Project-5510/RLU-Project-DEC7/RLU-Project/target/classes/rlu/benchmarks/jmh_generated/URCUCGSetBenchmark_g32for80_jmhTest.class", "Java", 0, 341, 0, 0, 0, 341
"/Users/ali/cs5510/Group-Project-5510/RLU-Project-DEC7/RLU-Project/target/classes/rlu/benchmarks/jmh_generated/URCUCGSetBenchmark_g8for20_jmhTest.class", "Java", 0, 341, 0, 0, 0, 341
"/Users/ali/cs5510/Group-Project-5510/RLU-Project-DEC7/RLU-Project/target/classes/rlu/benchmarks/jmh_generated/URCUCGSetBenchmark_g8for40_jmhTest.class", "Java", 0, 341, 0, 0, 0, 341
"/Users/ali/cs5510/Group-Project-5510/RLU-Project-DEC7/RLU-Project/target/classes/rlu/benchmarks/jmh_generated/URCUCGSetBenchmark_g8for60_jmhTest.class", "Java", 0, 341, 0, 0, 0, 341
"/Users/ali/cs5510/Group-Project-5510/RLU-Project-DEC7/RLU-Project/target/classes/rlu/benchmarks/jmh_generated/URCUCGSetBenchmark_g8for80_jmhTest.class", "Java", 0, 341, 0, 0, 0, 341
"/Users/ali/cs5510/Group-Project-5510/RLU-Project-DEC7/RLU-Project/target/classes/rlu/benchmarks/jmh_generated/URCUCGSetBenchmark_jmhType.class", "Java", 0, 5, 0, 0, 0, 5
"/Users/ali/cs5510/Group-Project-5510/RLU-Project-DEC7/RLU-Project/target/classes/rlu/benchmarks/jmh_generated/URCUCGSetBenchmark_jmhType_B1.class", "Java", 0, 7, 0, 0, 0, 7
"/Users/ali/cs5510/Group-Project-5510/RLU-Project-DEC7/RLU-Project/target/classes/rlu/benchmarks/jmh_generated/URCUCGSetBenchmark_jmhType_B2.class", "Java", 0, 15, 0, 0, 0, 15
"/Users/ali/cs5510/Group-Project-5510/RLU-Project-DEC7/RLU-Project/target/classes/rlu/benchmarks/jmh_generated/URCUCGSetBenchmark_jmhType_B3.class", "Java", 0, 7, 0, 0, 0, 7
"/Users/ali/cs5510/Group-Project-5510/RLU-Project-DEC7/RLU-Project/target/classes/rlu/benchmarks/jmh_generated/URCUFGSetBenchmark_GlobalState_jmhType.class", "Java", 0, 5, 0, 0, 0, 5
"/Users/ali/cs5510/Group-Project-5510/RLU-Project-DEC7/RLU-Project/target/classes/rlu/benchmarks/jmh_generated/URCUFGSetBenchmark_GlobalState_jmhType_B1.class", "Java", 0, 8, 0, 0, 0, 8
"/Users/ali/cs5510/Group-Project-5510/RLU-Project-DEC7/RLU-Project/target/classes/rlu/benchmarks/jmh_generated/URCUFGSetBenchmark_GlobalState_jmhType_B2.class", "Java", 0, 15, 0, 0, 0, 15
"/Users/ali/cs5510/Group-Project-5510/RLU-Project-DEC7/RLU-Project/target/classes/rlu/benchmarks/jmh_generated/URCUFGSetBenchmark_GlobalState_jmhType_B3.class", "Java", 0, 7, 0, 0, 0, 7
"/Users/ali/cs5510/Group-Project-5510/RLU-Project-DEC7/RLU-Project/target/classes/rlu/benchmarks/jmh_generated/URCUFGSetBenchmark_ThreadState_jmhType.class", "Java", 0, 5, 0, 0, 0, 5
"/Users/ali/cs5510/Group-Project-5510/RLU-Project-DEC7/RLU-Project/target/classes/rlu/benchmarks/jmh_generated/URCUFGSetBenchmark_ThreadState_jmhType_B1.class", "Java", 0, 8, 0, 0, 0, 8
"/Users/ali/cs5510/Group-Project-5510/RLU-Project-DEC7/RLU-Project/target/classes/rlu/benchmarks/jmh_generated/URCUFGSetBenchmark_ThreadState_jmhType_B2.class", "Java", 0, 14, 0, 0, 0, 14
"/Users/ali/cs5510/Group-Project-5510/RLU-Project-DEC7/RLU-Project/target/classes/rlu/benchmarks/jmh_generated/URCUFGSetBenchmark_ThreadState_jmhType_B3.class", "Java", 0, 7, 0, 0, 0, 7
"/Users/ali/cs5510/Group-Project-5510/RLU-Project-DEC7/RLU-Project/target/classes/rlu/benchmarks/jmh_generated/URCUFGSetBenchmark_g16for20_jmhTest.class", "Java", 0, 341, 0, 0, 0, 341
"/Users/ali/cs5510/Group-Project-5510/RLU-Project-DEC7/RLU-Project/target/classes/rlu/benchmarks/jmh_generated/URCUFGSetBenchmark_g16for40_jmhTest.class", "Java", 0, 341, 0, 0, 0, 341
"/Users/ali/cs5510/Group-Project-5510/RLU-Project-DEC7/RLU-Project/target/classes/rlu/benchmarks/jmh_generated/URCUFGSetBenchmark_g16for60_jmhTest.class", "Java", 0, 341, 0, 0, 0, 341
"/Users/ali/cs5510/Group-Project-5510/RLU-Project-DEC7/RLU-Project/target/classes/rlu/benchmarks/jmh_generated/URCUFGSetBenchmark_g16for80_jmhTest.class", "Java", 0, 341, 0, 0, 0, 341
"/Users/ali/cs5510/Group-Project-5510/RLU-Project-DEC7/RLU-Project/target/classes/rlu/benchmarks/jmh_generated/URCUFGSetBenchmark_g24for20_jmhTest.class", "Java", 0, 341, 0, 0, 0, 341
"/Users/ali/cs5510/Group-Project-5510/RLU-Project-DEC7/RLU-Project/target/classes/rlu/benchmarks/jmh_generated/URCUFGSetBenchmark_g24for40_jmhTest.class", "Java", 0, 341, 0, 0, 0, 341
"/Users/ali/cs5510/Group-Project-5510/RLU-Project-DEC7/RLU-Project/target/classes/rlu/benchmarks/jmh_generated/URCUFGSetBenchmark_g24for60_jmhTest.class", "Java", 0, 341, 0, 0, 0, 341
"/Users/ali/cs5510/Group-Project-5510/RLU-Project-DEC7/RLU-Project/target/classes/rlu/benchmarks/jmh_generated/URCUFGSetBenchmark_g24for80_jmhTest.class", "Java", 0, 341, 0, 0, 0, 341
"/Users/ali/cs5510/Group-Project-5510/RLU-Project-DEC7/RLU-Project/target/classes/rlu/benchmarks/jmh_generated/URCUFGSetBenchmark_g32for20_jmhTest.class", "Java", 0, 341, 0, 0, 0, 341
"/Users/ali/cs5510/Group-Project-5510/RLU-Project-DEC7/RLU-Project/target/classes/rlu/benchmarks/jmh_generated/URCUFGSetBenchmark_g32for40_jmhTest.class", "Java", 0, 341, 0, 0, 0, 341
"/Users/ali/cs5510/Group-Project-5510/RLU-Project-DEC7/RLU-Project/target/classes/rlu/benchmarks/jmh_generated/URCUFGSetBenchmark_g32for60_jmhTest.class", "Java", 0, 341, 0, 0, 0, 341
"/Users/ali/cs5510/Group-Project-5510/RLU-Project-DEC7/RLU-Project/target/classes/rlu/benchmarks/jmh_generated/URCUFGSetBenchmark_g32for80_jmhTest.class", "Java", 0, 341, 0, 0, 0, 341
"/Users/ali/cs5510/Group-Project-5510/RLU-Project-DEC7/RLU-Project/target/classes/rlu/benchmarks/jmh_generated/URCUFGSetBenchmark_g8for20_jmhTest.class", "Java", 0, 341, 0, 0, 0, 341
"/Users/ali/cs5510/Group-Project-5510/RLU-Project-DEC7/RLU-Project/target/classes/rlu/benchmarks/jmh_generated/URCUFGSetBenchmark_g8for40_jmhTest.class", "Java", 0, 341, 0, 0, 0, 341
"/Users/ali/cs5510/Group-Project-5510/RLU-Project-DEC7/RLU-Project/target/classes/rlu/benchmarks/jmh_generated/URCUFGSetBenchmark_g8for60_jmhTest.class", "Java", 0, 341, 0, 0, 0, 341
"/Users/ali/cs5510/Group-Project-5510/RLU-Project-DEC7/RLU-Project/target/classes/rlu/benchmarks/jmh_generated/URCUFGSetBenchmark_g8for80_jmhTest.class", "Java", 0, 341, 0, 0, 0, 341
"/Users/ali/cs5510/Group-Project-5510/RLU-Project-DEC7/RLU-Project/target/classes/rlu/benchmarks/jmh_generated/URCUFGSetBenchmark_jmhType.class", "Java", 0, 5, 0, 0, 0, 5
"/Users/ali/cs5510/Group-Project-5510/RLU-Project-DEC7/RLU-Project/target/classes/rlu/benchmarks/jmh_generated/URCUFGSetBenchmark_jmhType_B1.class", "Java", 0, 7, 0, 0, 0, 7
"/Users/ali/cs5510/Group-Project-5510/RLU-Project-DEC7/RLU-Project/target/classes/rlu/benchmarks/jmh_generated/URCUFGSetBenchmark_jmhType_B2.class", "Java", 0, 15, 0, 0, 0, 15
"/Users/ali/cs5510/Group-Project-5510/RLU-Project-DEC7/RLU-Project/target/classes/rlu/benchmarks/jmh_generated/URCUFGSetBenchmark_jmhType_B3.class", "Java", 0, 7, 0, 0, 0, 7
"/Users/ali/cs5510/Group-Project-5510/RLU-Project-DEC7/RLU-Project/target/classes/rlu/sets/ComparisonSets/CoarseBST$Node.class", "Java", 0, 49, 0, 0, 1, 50
"/Users/ali/cs5510/Group-Project-5510/RLU-Project-DEC7/RLU-Project/target/classes/rlu/sets/ComparisonSets/CoarseBST.class", "Java", 0, 53, 0, 0, 1, 54
"/Users/ali/cs5510/Group-Project-5510/RLU-Project-DEC7/RLU-Project/target/classes/rlu/sets/ComparisonSets/CoarseSet$Node.class", "Java", 0, 10, 0, 0, 1, 11
"/Users/ali/cs5510/Group-Project-5510/RLU-Project-DEC7/RLU-Project/target/classes/rlu/sets/ComparisonSets/CoarseSet.class", "Java", 0, 26, 0, 0, 1, 27
"/Users/ali/cs5510/Group-Project-5510/RLU-Project-DEC7/RLU-Project/target/classes/rlu/sets/ComparisonSets/FineBST$Node.class", "Java", 0, 50, 0, 0, 1, 51
"/Users/ali/cs5510/Group-Project-5510/RLU-Project-DEC7/RLU-Project/target/classes/rlu/sets/ComparisonSets/FineBST.class", "Java", 0, 55, 0, 0, 1, 56
"/Users/ali/cs5510/Group-Project-5510/RLU-Project-DEC7/RLU-Project/target/classes/rlu/sets/ComparisonSets/FineSet$Node.class", "Java", 0, 24, 0, 0, 1, 25
"/Users/ali/cs5510/Group-Project-5510/RLU-Project-DEC7/RLU-Project/target/classes/rlu/sets/ComparisonSets/FineSet.class", "Java", 0, 23, 0, 0, 1, 24
"/Users/ali/cs5510/Group-Project-5510/RLU-Project-DEC7/RLU-Project/target/classes/rlu/sets/ComparisonSets/LockFreeSet$Node.class", "Java", 0, 10, 0, 0, 1, 11
"/Users/ali/cs5510/Group-Project-5510/RLU-Project-DEC7/RLU-Project/target/classes/rlu/sets/ComparisonSets/LockFreeSet$Window.class", "Java", 0, 7, 0, 0, 1, 8
"/Users/ali/cs5510/Group-Project-5510/RLU-Project-DEC7/RLU-Project/target/classes/rlu/sets/ComparisonSets/LockFreeSet.class", "Java", 0, 36, 0, 0, 1, 37
"/Users/ali/cs5510/Group-Project-5510/RLU-Project-DEC7/RLU-Project/target/classes/rlu/sets/ComparisonSets/Threads.class", "Java", 0, 6, 0, 0, 0, 6
"/Users/ali/cs5510/Group-Project-5510/RLU-Project-DEC7/RLU-Project/target/classes/rlu/sets/RLUBST/HeaderBST.class", "Java", 0, 11, 0, 0, 0, 11
"/Users/ali/cs5510/Group-Project-5510/RLU-Project-DEC7/RLU-Project/target/classes/rlu/sets/RLUBST/RLUBSTNode.class", "Java", 0, 48, 0, 0, 0, 48
"/Users/ali/cs5510/Group-Project-5510/RLU-Project-DEC7/RLU-Project/target/classes/rlu/sets/RLUBST/RLUCoarseSetBST.class", "Java", 0, 41, 0, 10, 0, 51
"/Users/ali/cs5510/Group-Project-5510/RLU-Project-DEC7/RLU-Project/target/classes/rlu/sets/RLUBST/RLUFineSetBST.class", "Java", 0, 41, 0, 8, 0, 49
"/Users/ali/cs5510/Group-Project-5510/RLU-Project-DEC7/RLU-Project/target/classes/rlu/sets/RLUBST/RluThread.class", "Java", 0, 9, 0, 0, 0, 9
"/Users/ali/cs5510/Group-Project-5510/RLU-Project-DEC7/RLU-Project/target/classes/rlu/sets/RluSets/Header.class", "Java", 0, 12, 0, 0, 0, 12
"/Users/ali/cs5510/Group-Project-5510/RLU-Project-DEC7/RLU-Project/target/classes/rlu/sets/RluSets/RluMultiObjCoarseSet.class", "Java", 0, 48, 0, 0, 0, 48
"/Users/ali/cs5510/Group-Project-5510/RLU-Project-DEC7/RLU-Project/target/classes/rlu/sets/RluSets/RluNode.class", "Java", 0, 24, 0, 0, 0, 24
"/Users/ali/cs5510/Group-Project-5510/RLU-Project-DEC7/RLU-Project/target/classes/rlu/sets/RluSets/RluSetInterface.class", "Java", 0, 4, 0, 0, 0, 4
"/Users/ali/cs5510/Group-Project-5510/RLU-Project-DEC7/RLU-Project/target/classes/rlu/sets/RluSets/RluThread.class", "Java", 0, 9, 0, 0, 0, 9
"/Users/ali/cs5510/Group-Project-5510/RLU-Project-DEC7/RLU-Project/target/classes/rlu/sets/RluSets/SingleObjRluCoarseSet.class", "Java", 0, 35, 0, 0, 0, 35
"/Users/ali/cs5510/Group-Project-5510/RLU-Project-DEC7/RLU-Project/target/classes/rlu/sets/RluSets/SingleObjRluFineSet.class", "Java", 0, 34, 0, 0, 0, 34
"/Users/ali/cs5510/Group-Project-5510/RLU-Project-DEC7/RLU-Project/target/classes/rlu/sets/RluSets/SingleObjRluPaddedCoarseSet.class", "Java", 0, 42, 0, 0, 0, 42
"/Users/ali/cs5510/Group-Project-5510/RLU-Project-DEC7/RLU-Project/target/classes/rlu/sets/URCU/CoarseSetURCU.class", "Java", 0, 29, 0, 21, 0, 50
"/Users/ali/cs5510/Group-Project-5510/RLU-Project-DEC7/RLU-Project/target/classes/rlu/sets/URCU/FineSetURCU.class", "Java", 0, 31, 0, 19, 0, 50
"/Users/ali/cs5510/Group-Project-5510/RLU-Project-DEC7/RLU-Project/target/classes/rlu/sets/URCU/RcuNode.class", "Java", 0, 24, 0, 0, 0, 24
"/Users/ali/cs5510/Group-Project-5510/RLU-Project-DEC7/RLU-Project/target/classes/rlu/sets/URCU/RcuSetInterface.class", "Java", 0, 3, 0, 0, 1, 4
"/Users/ali/cs5510/Group-Project-5510/RLU-Project-DEC7/RLU-Project/target/classes/rlu/sets/URCU/RcuThread.class", "Java", 0, 9, 0, 0, 0, 9
"/Users/ali/cs5510/Group-Project-5510/RLU-Project-DEC7/RLU-Project/target/classes/rlu/sets/interfaces/ComparableSet.class", "Java", 0, 3, 0, 0, 1, 4
"/Users/ali/cs5510/Group-Project-5510/RLU-Project-DEC7/RLU-Project/target/classes/rlu/sets/interfaces/ComparisonSet.class", "Java", 0, 3, 0, 0, 1, 4
"/Users/ali/cs5510/Group-Project-5510/RLU-Project-DEC7/RLU-Project/target/classes/rlu/sets/interfaces/Set.class", "Java", 0, 3, 0, 0, 1, 4
"/Users/ali/cs5510/Group-Project-5510/RLU-Project-DEC7/RLU-Project/target/classes/rlu/sets/interfaces/Sorted.class", "Java", 0, 3, 0, 0, 1, 4
"/Users/ali/cs5510/Group-Project-5510/RLU-Project-DEC7/RLU-Project/target/classes/rlu/threads/ComparisonFineReader.class", "Java", 0, 19, 0, 0, 0, 19
"/Users/ali/cs5510/Group-Project-5510/RLU-Project-DEC7/RLU-Project/target/classes/rlu/threads/ComparisonFineWriter.class", "Java", 0, 19, 0, 0, 0, 19
"/Users/ali/cs5510/Group-Project-5510/RLU-Project-DEC7/RLU-Project/target/classes/rlu/threads/MultiWriterThread.class", "Java", 0, 18, 0, 0, 0, 18
"/Users/ali/cs5510/Group-Project-5510/RLU-Project-DEC7/RLU-Project/target/classes/rlu/threads/RcuReader.class", "Java", 0, 22, 0, 0, 0, 22
"/Users/ali/cs5510/Group-Project-5510/RLU-Project-DEC7/RLU-Project/target/classes/rlu/threads/RcuWriter.class", "Java", 0, 23, 0, 0, 0, 23
"/Users/ali/cs5510/Group-Project-5510/RLU-Project-DEC7/RLU-Project/target/classes/rlu/threads/ReaderBST.class", "Java", 0, 19, 0, 0, 0, 19
"/Users/ali/cs5510/Group-Project-5510/RLU-Project-DEC7/RLU-Project/target/classes/rlu/threads/ReaderThread.class", "Java", 0, 18, 0, 0, 0, 18
"/Users/ali/cs5510/Group-Project-5510/RLU-Project-DEC7/RLU-Project/target/classes/rlu/threads/WriterBST.class", "Java", 0, 19, 0, 0, 0, 19
"/Users/ali/cs5510/Group-Project-5510/RLU-Project-DEC7/RLU-Project/target/classes/rlu/threads/WriterThread.class", "Java", 0, 18, 0, 0, 0, 18
"/Users/ali/cs5510/Group-Project-5510/RLU-Project-DEC7/RLU-Project/target/generated-sources/annotations/rlu/benchmarks/jmh_generated/CoarseBSTBenchmark_MyState_jmhType.java", "Java", 0, 3, 0, 0, 2, 5
"/Users/ali/cs5510/Group-Project-5510/RLU-Project-DEC7/RLU-Project/target/generated-sources/annotations/rlu/benchmarks/jmh_generated/CoarseBSTBenchmark_MyState_jmhType_B1.java", "Java", 0, 20, 0, 0, 1, 21
"/Users/ali/cs5510/Group-Project-5510/RLU-Project-DEC7/RLU-Project/target/generated-sources/annotations/rlu/benchmarks/jmh_generated/CoarseBSTBenchmark_MyState_jmhType_B2.java", "Java", 0, 19, 0, 0, 4, 23
"/Users/ali/cs5510/Group-Project-5510/RLU-Project-DEC7/RLU-Project/target/generated-sources/annotations/rlu/benchmarks/jmh_generated/CoarseBSTBenchmark_MyState_jmhType_B3.java", "Java", 0, 19, 0, 0, 2, 21
"/Users/ali/cs5510/Group-Project-5510/RLU-Project-DEC7/RLU-Project/target/generated-sources/annotations/rlu/benchmarks/jmh_generated/CoarseBSTBenchmark_g16for20_jmhTest.java", "Java", 0, 1660, 0, 0, 65, 1725
"/Users/ali/cs5510/Group-Project-5510/RLU-Project-DEC7/RLU-Project/target/generated-sources/annotations/rlu/benchmarks/jmh_generated/CoarseBSTBenchmark_g16for40_jmhTest.java", "Java", 0, 1660, 0, 0, 65, 1725
"/Users/ali/cs5510/Group-Project-5510/RLU-Project-DEC7/RLU-Project/target/generated-sources/annotations/rlu/benchmarks/jmh_generated/CoarseBSTBenchmark_g16for60_jmhTest.java", "Java", 0, 1660, 0, 0, 65, 1725
"/Users/ali/cs5510/Group-Project-5510/RLU-Project-DEC7/RLU-Project/target/generated-sources/annotations/rlu/benchmarks/jmh_generated/CoarseBSTBenchmark_g16for80_jmhTest.java", "Java", 0, 1660, 0, 0, 65, 1725
"/Users/ali/cs5510/Group-Project-5510/RLU-Project-DEC7/RLU-Project/target/generated-sources/annotations/rlu/benchmarks/jmh_generated/CoarseBSTBenchmark_g24for20_jmhTest.java", "Java", 0, 1660, 0, 0, 65, 1725
"/Users/ali/cs5510/Group-Project-5510/RLU-Project-DEC7/RLU-Project/target/generated-sources/annotations/rlu/benchmarks/jmh_generated/CoarseBSTBenchmark_g24for40_jmhTest.java", "Java", 0, 1660, 0, 0, 65, 1725
"/Users/ali/cs5510/Group-Project-5510/RLU-Project-DEC7/RLU-Project/target/generated-sources/annotations/rlu/benchmarks/jmh_generated/CoarseBSTBenchmark_g24for60_jmhTest.java", "Java", 0, 1660, 0, 0, 65, 1725
"/Users/ali/cs5510/Group-Project-5510/RLU-Project-DEC7/RLU-Project/target/generated-sources/annotations/rlu/benchmarks/jmh_generated/CoarseBSTBenchmark_g24for80_jmhTest.java", "Java", 0, 1660, 0, 0, 65, 1725
"/Users/ali/cs5510/Group-Project-5510/RLU-Project-DEC7/RLU-Project/target/generated-sources/annotations/rlu/benchmarks/jmh_generated/CoarseBSTBenchmark_g32for20_jmhTest.java", "Java", 0, 1660, 0, 0, 65, 1725
"/Users/ali/cs5510/Group-Project-5510/RLU-Project-DEC7/RLU-Project/target/generated-sources/annotations/rlu/benchmarks/jmh_generated/CoarseBSTBenchmark_g32for40_jmhTest.java", "Java", 0, 1660, 0, 0, 65, 1725
"/Users/ali/cs5510/Group-Project-5510/RLU-Project-DEC7/RLU-Project/target/generated-sources/annotations/rlu/benchmarks/jmh_generated/CoarseBSTBenchmark_g32for60_jmhTest.java", "Java", 0, 1660, 0, 0, 65, 1725
"/Users/ali/cs5510/Group-Project-5510/RLU-Project-DEC7/RLU-Project/target/generated-sources/annotations/rlu/benchmarks/jmh_generated/CoarseBSTBenchmark_g32for80_jmhTest.java", "Java", 0, 1660, 0, 0, 65, 1725
"/Users/ali/cs5510/Group-Project-5510/RLU-Project-DEC7/RLU-Project/target/generated-sources/annotations/rlu/benchmarks/jmh_generated/CoarseBSTBenchmark_g8for20_jmhTest.java", "Java", 0, 1660, 0, 0, 65, 1725
"/Users/ali/cs5510/Group-Project-5510/RLU-Project-DEC7/RLU-Project/target/generated-sources/annotations/rlu/benchmarks/jmh_generated/CoarseBSTBenchmark_g8for40_jmhTest.java", "Java", 0, 1660, 0, 0, 65, 1725
"/Users/ali/cs5510/Group-Project-5510/RLU-Project-DEC7/RLU-Project/target/generated-sources/annotations/rlu/benchmarks/jmh_generated/CoarseBSTBenchmark_g8for60_jmhTest.java", "Java", 0, 1660, 0, 0, 65, 1725
"/Users/ali/cs5510/Group-Project-5510/RLU-Project-DEC7/RLU-Project/target/generated-sources/annotations/rlu/benchmarks/jmh_generated/CoarseBSTBenchmark_g8for80_jmhTest.java", "Java", 0, 1660, 0, 0, 65, 1725
"/Users/ali/cs5510/Group-Project-5510/RLU-Project-DEC7/RLU-Project/target/generated-sources/annotations/rlu/benchmarks/jmh_generated/CoarseBSTBenchmark_jmhType.java", "Java", 0, 3, 0, 0, 2, 5
"/Users/ali/cs5510/Group-Project-5510/RLU-Project-DEC7/RLU-Project/target/generated-sources/annotations/rlu/benchmarks/jmh_generated/CoarseBSTBenchmark_jmhType_B1.java", "Java", 0, 20, 0, 0, 1, 21
"/Users/ali/cs5510/Group-Project-5510/RLU-Project-DEC7/RLU-Project/target/generated-sources/annotations/rlu/benchmarks/jmh_generated/CoarseBSTBenchmark_jmhType_B2.java", "Java", 0, 19, 0, 0, 4, 23
"/Users/ali/cs5510/Group-Project-5510/RLU-Project-DEC7/RLU-Project/target/generated-sources/annotations/rlu/benchmarks/jmh_generated/CoarseBSTBenchmark_jmhType_B3.java", "Java", 0, 19, 0, 0, 2, 21
"/Users/ali/cs5510/Group-Project-5510/RLU-Project-DEC7/RLU-Project/target/generated-sources/annotations/rlu/benchmarks/jmh_generated/CoarseSetBenchmark_MyState_jmhType.java", "Java", 0, 3, 0, 0, 2, 5
"/Users/ali/cs5510/Group-Project-5510/RLU-Project-DEC7/RLU-Project/target/generated-sources/annotations/rlu/benchmarks/jmh_generated/CoarseSetBenchmark_MyState_jmhType_B1.java", "Java", 0, 20, 0, 0, 1, 21
"/Users/ali/cs5510/Group-Project-5510/RLU-Project-DEC7/RLU-Project/target/generated-sources/annotations/rlu/benchmarks/jmh_generated/CoarseSetBenchmark_MyState_jmhType_B2.java", "Java", 0, 19, 0, 0, 4, 23
"/Users/ali/cs5510/Group-Project-5510/RLU-Project-DEC7/RLU-Project/target/generated-sources/annotations/rlu/benchmarks/jmh_generated/CoarseSetBenchmark_MyState_jmhType_B3.java", "Java", 0, 19, 0, 0, 2, 21
"/Users/ali/cs5510/Group-Project-5510/RLU-Project-DEC7/RLU-Project/target/generated-sources/annotations/rlu/benchmarks/jmh_generated/CoarseSetBenchmark_g16for20_jmhTest.java", "Java", 0, 1660, 0, 0, 65, 1725
"/Users/ali/cs5510/Group-Project-5510/RLU-Project-DEC7/RLU-Project/target/generated-sources/annotations/rlu/benchmarks/jmh_generated/CoarseSetBenchmark_g16for40_jmhTest.java", "Java", 0, 1660, 0, 0, 65, 1725
"/Users/ali/cs5510/Group-Project-5510/RLU-Project-DEC7/RLU-Project/target/generated-sources/annotations/rlu/benchmarks/jmh_generated/CoarseSetBenchmark_g16for60_jmhTest.java", "Java", 0, 1660, 0, 0, 65, 1725
"/Users/ali/cs5510/Group-Project-5510/RLU-Project-DEC7/RLU-Project/target/generated-sources/annotations/rlu/benchmarks/jmh_generated/CoarseSetBenchmark_g16for80_jmhTest.java", "Java", 0, 1660, 0, 0, 65, 1725
"/Users/ali/cs5510/Group-Project-5510/RLU-Project-DEC7/RLU-Project/target/generated-sources/annotations/rlu/benchmarks/jmh_generated/CoarseSetBenchmark_g24for20_jmhTest.java", "Java", 0, 1660, 0, 0, 65, 1725
"/Users/ali/cs5510/Group-Project-5510/RLU-Project-DEC7/RLU-Project/target/generated-sources/annotations/rlu/benchmarks/jmh_generated/CoarseSetBenchmark_g24for40_jmhTest.java", "Java", 0, 1660, 0, 0, 65, 1725
"/Users/ali/cs5510/Group-Project-5510/RLU-Project-DEC7/RLU-Project/target/generated-sources/annotations/rlu/benchmarks/jmh_generated/CoarseSetBenchmark_g24for60_jmhTest.java", "Java", 0, 1660, 0, 0, 65, 1725
"/Users/ali/cs5510/Group-Project-5510/RLU-Project-DEC7/RLU-Project/target/generated-sources/annotations/rlu/benchmarks/jmh_generated/CoarseSetBenchmark_g24for80_jmhTest.java", "Java", 0, 1660, 0, 0, 65, 1725
"/Users/ali/cs5510/Group-Project-5510/RLU-Project-DEC7/RLU-Project/target/generated-sources/annotations/rlu/benchmarks/jmh_generated/CoarseSetBenchmark_g32for20_jmhTest.java", "Java", 0, 1660, 0, 0, 65, 1725
"/Users/ali/cs5510/Group-Project-5510/RLU-Project-DEC7/RLU-Project/target/generated-sources/annotations/rlu/benchmarks/jmh_generated/CoarseSetBenchmark_g32for40_jmhTest.java", "Java", 0, 1660, 0, 0, 65, 1725
"/Users/ali/cs5510/Group-Project-5510/RLU-Project-DEC7/RLU-Project/target/generated-sources/annotations/rlu/benchmarks/jmh_generated/CoarseSetBenchmark_g32for60_jmhTest.java", "Java", 0, 1660, 0, 0, 65, 1725
"/Users/ali/cs5510/Group-Project-5510/RLU-Project-DEC7/RLU-Project/target/generated-sources/annotations/rlu/benchmarks/jmh_generated/CoarseSetBenchmark_g32for80_jmhTest.java", "Java", 0, 1660, 0, 0, 65, 1725
"/Users/ali/cs5510/Group-Project-5510/RLU-Project-DEC7/RLU-Project/target/generated-sources/annotations/rlu/benchmarks/jmh_generated/CoarseSetBenchmark_g8for20_jmhTest.java", "Java", 0, 1660, 0, 0, 65, 1725
"/Users/ali/cs5510/Group-Project-5510/RLU-Project-DEC7/RLU-Project/target/generated-sources/annotations/rlu/benchmarks/jmh_generated/CoarseSetBenchmark_g8for40_jmhTest.java", "Java", 0, 1660, 0, 0, 65, 1725
"/Users/ali/cs5510/Group-Project-5510/RLU-Project-DEC7/RLU-Project/target/generated-sources/annotations/rlu/benchmarks/jmh_generated/CoarseSetBenchmark_g8for60_jmhTest.java", "Java", 0, 1660, 0, 0, 65, 1725
"/Users/ali/cs5510/Group-Project-5510/RLU-Project-DEC7/RLU-Project/target/generated-sources/annotations/rlu/benchmarks/jmh_generated/CoarseSetBenchmark_g8for80_jmhTest.java", "Java", 0, 1660, 0, 0, 65, 1725
"/Users/ali/cs5510/Group-Project-5510/RLU-Project-DEC7/RLU-Project/target/generated-sources/annotations/rlu/benchmarks/jmh_generated/CoarseSetBenchmark_jmhType.java", "Java", 0, 3, 0, 0, 2, 5
"/Users/ali/cs5510/Group-Project-5510/RLU-Project-DEC7/RLU-Project/target/generated-sources/annotations/rlu/benchmarks/jmh_generated/CoarseSetBenchmark_jmhType_B1.java", "Java", 0, 20, 0, 0, 1, 21
"/Users/ali/cs5510/Group-Project-5510/RLU-Project-DEC7/RLU-Project/target/generated-sources/annotations/rlu/benchmarks/jmh_generated/CoarseSetBenchmark_jmhType_B2.java", "Java", 0, 19, 0, 0, 4, 23
"/Users/ali/cs5510/Group-Project-5510/RLU-Project-DEC7/RLU-Project/target/generated-sources/annotations/rlu/benchmarks/jmh_generated/CoarseSetBenchmark_jmhType_B3.java", "Java", 0, 19, 0, 0, 2, 21
"/Users/ali/cs5510/Group-Project-5510/RLU-Project-DEC7/RLU-Project/target/generated-sources/annotations/rlu/benchmarks/jmh_generated/FineBSTBenchmark_MyState_jmhType.java", "Java", 0, 3, 0, 0, 2, 5
"/Users/ali/cs5510/Group-Project-5510/RLU-Project-DEC7/RLU-Project/target/generated-sources/annotations/rlu/benchmarks/jmh_generated/FineBSTBenchmark_MyState_jmhType_B1.java", "Java", 0, 20, 0, 0, 1, 21
"/Users/ali/cs5510/Group-Project-5510/RLU-Project-DEC7/RLU-Project/target/generated-sources/annotations/rlu/benchmarks/jmh_generated/FineBSTBenchmark_MyState_jmhType_B2.java", "Java", 0, 19, 0, 0, 4, 23
"/Users/ali/cs5510/Group-Project-5510/RLU-Project-DEC7/RLU-Project/target/generated-sources/annotations/rlu/benchmarks/jmh_generated/FineBSTBenchmark_MyState_jmhType_B3.java", "Java", 0, 19, 0, 0, 2, 21
"/Users/ali/cs5510/Group-Project-5510/RLU-Project-DEC7/RLU-Project/target/generated-sources/annotations/rlu/benchmarks/jmh_generated/FineBSTBenchmark_g16for20_jmhTest.java", "Java", 0, 1660, 0, 0, 65, 1725
"/Users/ali/cs5510/Group-Project-5510/RLU-Project-DEC7/RLU-Project/target/generated-sources/annotations/rlu/benchmarks/jmh_generated/FineBSTBenchmark_g16for40_jmhTest.java", "Java", 0, 1660, 0, 0, 65, 1725
"/Users/ali/cs5510/Group-Project-5510/RLU-Project-DEC7/RLU-Project/target/generated-sources/annotations/rlu/benchmarks/jmh_generated/FineBSTBenchmark_g16for60_jmhTest.java", "Java", 0, 1660, 0, 0, 65, 1725
"/Users/ali/cs5510/Group-Project-5510/RLU-Project-DEC7/RLU-Project/target/generated-sources/annotations/rlu/benchmarks/jmh_generated/FineBSTBenchmark_g16for80_jmhTest.java", "Java", 0, 1660, 0, 0, 65, 1725
"/Users/ali/cs5510/Group-Project-5510/RLU-Project-DEC7/RLU-Project/target/generated-sources/annotations/rlu/benchmarks/jmh_generated/FineBSTBenchmark_g24for20_jmhTest.java", "Java", 0, 1660, 0, 0, 65, 1725
"/Users/ali/cs5510/Group-Project-5510/RLU-Project-DEC7/RLU-Project/target/generated-sources/annotations/rlu/benchmarks/jmh_generated/FineBSTBenchmark_g24for40_jmhTest.java", "Java", 0, 1660, 0, 0, 65, 1725
"/Users/ali/cs5510/Group-Project-5510/RLU-Project-DEC7/RLU-Project/target/generated-sources/annotations/rlu/benchmarks/jmh_generated/FineBSTBenchmark_g24for60_jmhTest.java", "Java", 0, 1660, 0, 0, 65, 1725
"/Users/ali/cs5510/Group-Project-5510/RLU-Project-DEC7/RLU-Project/target/generated-sources/annotations/rlu/benchmarks/jmh_generated/FineBSTBenchmark_g24for80_jmhTest.java", "Java", 0, 1660, 0, 0, 65, 1725
"/Users/ali/cs5510/Group-Project-5510/RLU-Project-DEC7/RLU-Project/target/generated-sources/annotations/rlu/benchmarks/jmh_generated/FineBSTBenchmark_g32for20_jmhTest.java", "Java", 0, 1660, 0, 0, 65, 1725
"/Users/ali/cs5510/Group-Project-5510/RLU-Project-DEC7/RLU-Project/target/generated-sources/annotations/rlu/benchmarks/jmh_generated/FineBSTBenchmark_g32for40_jmhTest.java", "Java", 0, 1660, 0, 0, 65, 1725
"/Users/ali/cs5510/Group-Project-5510/RLU-Project-DEC7/RLU-Project/target/generated-sources/annotations/rlu/benchmarks/jmh_generated/FineBSTBenchmark_g32for60_jmhTest.java", "Java", 0, 1660, 0, 0, 65, 1725
"/Users/ali/cs5510/Group-Project-5510/RLU-Project-DEC7/RLU-Project/target/generated-sources/annotations/rlu/benchmarks/jmh_generated/FineBSTBenchmark_g32for80_jmhTest.java", "Java", 0, 1660, 0, 0, 65, 1725
"/Users/ali/cs5510/Group-Project-5510/RLU-Project-DEC7/RLU-Project/target/generated-sources/annotations/rlu/benchmarks/jmh_generated/FineBSTBenchmark_g8for20_jmhTest.java", "Java", 0, 1660, 0, 0, 65, 1725
"/Users/ali/cs5510/Group-Project-5510/RLU-Project-DEC7/RLU-Project/target/generated-sources/annotations/rlu/benchmarks/jmh_generated/FineBSTBenchmark_g8for40_jmhTest.java", "Java", 0, 1660, 0, 0, 65, 1725
"/Users/ali/cs5510/Group-Project-5510/RLU-Project-DEC7/RLU-Project/target/generated-sources/annotations/rlu/benchmarks/jmh_generated/FineBSTBenchmark_g8for60_jmhTest.java", "Java", 0, 1660, 0, 0, 65, 1725
"/Users/ali/cs5510/Group-Project-5510/RLU-Project-DEC7/RLU-Project/target/generated-sources/annotations/rlu/benchmarks/jmh_generated/FineBSTBenchmark_g8for80_jmhTest.java", "Java", 0, 1660, 0, 0, 65, 1725
"/Users/ali/cs5510/Group-Project-5510/RLU-Project-DEC7/RLU-Project/target/generated-sources/annotations/rlu/benchmarks/jmh_generated/FineBSTBenchmark_jmhType.java", "Java", 0, 3, 0, 0, 2, 5
"/Users/ali/cs5510/Group-Project-5510/RLU-Project-DEC7/RLU-Project/target/generated-sources/annotations/rlu/benchmarks/jmh_generated/FineBSTBenchmark_jmhType_B1.java", "Java", 0, 20, 0, 0, 1, 21
"/Users/ali/cs5510/Group-Project-5510/RLU-Project-DEC7/RLU-Project/target/generated-sources/annotations/rlu/benchmarks/jmh_generated/FineBSTBenchmark_jmhType_B2.java", "Java", 0, 19, 0, 0, 4, 23
"/Users/ali/cs5510/Group-Project-5510/RLU-Project-DEC7/RLU-Project/target/generated-sources/annotations/rlu/benchmarks/jmh_generated/FineBSTBenchmark_jmhType_B3.java", "Java", 0, 19, 0, 0, 2, 21
"/Users/ali/cs5510/Group-Project-5510/RLU-Project-DEC7/RLU-Project/target/generated-sources/annotations/rlu/benchmarks/jmh_generated/FineSetBenchmark_MyState_jmhType.java", "Java", 0, 3, 0, 0, 2, 5
"/Users/ali/cs5510/Group-Project-5510/RLU-Project-DEC7/RLU-Project/target/generated-sources/annotations/rlu/benchmarks/jmh_generated/FineSetBenchmark_MyState_jmhType_B1.java", "Java", 0, 20, 0, 0, 1, 21
"/Users/ali/cs5510/Group-Project-5510/RLU-Project-DEC7/RLU-Project/target/generated-sources/annotations/rlu/benchmarks/jmh_generated/FineSetBenchmark_MyState_jmhType_B2.java", "Java", 0, 19, 0, 0, 4, 23
"/Users/ali/cs5510/Group-Project-5510/RLU-Project-DEC7/RLU-Project/target/generated-sources/annotations/rlu/benchmarks/jmh_generated/FineSetBenchmark_MyState_jmhType_B3.java", "Java", 0, 19, 0, 0, 2, 21
"/Users/ali/cs5510/Group-Project-5510/RLU-Project-DEC7/RLU-Project/target/generated-sources/annotations/rlu/benchmarks/jmh_generated/FineSetBenchmark_g16for20_jmhTest.java", "Java", 0, 1652, 0, 0, 65, 1717
"/Users/ali/cs5510/Group-Project-5510/RLU-Project-DEC7/RLU-Project/target/generated-sources/annotations/rlu/benchmarks/jmh_generated/FineSetBenchmark_g16for40_jmhTest.java", "Java", 0, 1652, 0, 0, 65, 1717
"/Users/ali/cs5510/Group-Project-5510/RLU-Project-DEC7/RLU-Project/target/generated-sources/annotations/rlu/benchmarks/jmh_generated/FineSetBenchmark_g16for60_jmhTest.java", "Java", 0, 1652, 0, 0, 65, 1717
"/Users/ali/cs5510/Group-Project-5510/RLU-Project-DEC7/RLU-Project/target/generated-sources/annotations/rlu/benchmarks/jmh_generated/FineSetBenchmark_g16for80_jmhTest.java", "Java", 0, 1652, 0, 0, 65, 1717
"/Users/ali/cs5510/Group-Project-5510/RLU-Project-DEC7/RLU-Project/target/generated-sources/annotations/rlu/benchmarks/jmh_generated/FineSetBenchmark_g24for20_jmhTest.java", "Java", 0, 1652, 0, 0, 65, 1717
"/Users/ali/cs5510/Group-Project-5510/RLU-Project-DEC7/RLU-Project/target/generated-sources/annotations/rlu/benchmarks/jmh_generated/FineSetBenchmark_g24for40_jmhTest.java", "Java", 0, 1652, 0, 0, 65, 1717
"/Users/ali/cs5510/Group-Project-5510/RLU-Project-DEC7/RLU-Project/target/generated-sources/annotations/rlu/benchmarks/jmh_generated/FineSetBenchmark_g24for60_jmhTest.java", "Java", 0, 1652, 0, 0, 65, 1717
"/Users/ali/cs5510/Group-Project-5510/RLU-Project-DEC7/RLU-Project/target/generated-sources/annotations/rlu/benchmarks/jmh_generated/FineSetBenchmark_g24for80_jmhTest.java", "Java", 0, 1652, 0, 0, 65, 1717
"/Users/ali/cs5510/Group-Project-5510/RLU-Project-DEC7/RLU-Project/target/generated-sources/annotations/rlu/benchmarks/jmh_generated/FineSetBenchmark_g32for20_jmhTest.java", "Java", 0, 1652, 0, 0, 65, 1717
"/Users/ali/cs5510/Group-Project-5510/RLU-Project-DEC7/RLU-Project/target/generated-sources/annotations/rlu/benchmarks/jmh_generated/FineSetBenchmark_g32for40_jmhTest.java", "Java", 0, 1652, 0, 0, 65, 1717
"/Users/ali/cs5510/Group-Project-5510/RLU-Project-DEC7/RLU-Project/target/generated-sources/annotations/rlu/benchmarks/jmh_generated/FineSetBenchmark_g32for60_jmhTest.java", "Java", 0, 1652, 0, 0, 65, 1717
"/Users/ali/cs5510/Group-Project-5510/RLU-Project-DEC7/RLU-Project/target/generated-sources/annotations/rlu/benchmarks/jmh_generated/FineSetBenchmark_g32for80_jmhTest.java", "Java", 0, 1652, 0, 0, 65, 1717
"/Users/ali/cs5510/Group-Project-5510/RLU-Project-DEC7/RLU-Project/target/generated-sources/annotations/rlu/benchmarks/jmh_generated/FineSetBenchmark_g8for20_jmhTest.java", "Java", 0, 1652, 0, 0, 65, 1717
"/Users/ali/cs5510/Group-Project-5510/RLU-Project-DEC7/RLU-Project/target/generated-sources/annotations/rlu/benchmarks/jmh_generated/FineSetBenchmark_g8for40_jmhTest.java", "Java", 0, 1652, 0, 0, 65, 1717
"/Users/ali/cs5510/Group-Project-5510/RLU-Project-DEC7/RLU-Project/target/generated-sources/annotations/rlu/benchmarks/jmh_generated/FineSetBenchmark_g8for60_jmhTest.java", "Java", 0, 1652, 0, 0, 65, 1717
"/Users/ali/cs5510/Group-Project-5510/RLU-Project-DEC7/RLU-Project/target/generated-sources/annotations/rlu/benchmarks/jmh_generated/FineSetBenchmark_g8for80_jmhTest.java", "Java", 0, 1652, 0, 0, 65, 1717
"/Users/ali/cs5510/Group-Project-5510/RLU-Project-DEC7/RLU-Project/target/generated-sources/annotations/rlu/benchmarks/jmh_generated/FineSetBenchmark_jmhType.java", "Java", 0, 3, 0, 0, 2, 5
"/Users/ali/cs5510/Group-Project-5510/RLU-Project-DEC7/RLU-Project/target/generated-sources/annotations/rlu/benchmarks/jmh_generated/FineSetBenchmark_jmhType_B1.java", "Java", 0, 20, 0, 0, 1, 21
"/Users/ali/cs5510/Group-Project-5510/RLU-Project-DEC7/RLU-Project/target/generated-sources/annotations/rlu/benchmarks/jmh_generated/FineSetBenchmark_jmhType_B2.java", "Java", 0, 19, 0, 0, 4, 23
"/Users/ali/cs5510/Group-Project-5510/RLU-Project-DEC7/RLU-Project/target/generated-sources/annotations/rlu/benchmarks/jmh_generated/FineSetBenchmark_jmhType_B3.java", "Java", 0, 19, 0, 0, 2, 21
"/Users/ali/cs5510/Group-Project-5510/RLU-Project-DEC7/RLU-Project/target/generated-sources/annotations/rlu/benchmarks/jmh_generated/LockFreeSetBenchmark_MyState_jmhType.java", "Java", 0, 3, 0, 0, 2, 5
"/Users/ali/cs5510/Group-Project-5510/RLU-Project-DEC7/RLU-Project/target/generated-sources/annotations/rlu/benchmarks/jmh_generated/LockFreeSetBenchmark_MyState_jmhType_B1.java", "Java", 0, 20, 0, 0, 1, 21
"/Users/ali/cs5510/Group-Project-5510/RLU-Project-DEC7/RLU-Project/target/generated-sources/annotations/rlu/benchmarks/jmh_generated/LockFreeSetBenchmark_MyState_jmhType_B2.java", "Java", 0, 19, 0, 0, 4, 23
"/Users/ali/cs5510/Group-Project-5510/RLU-Project-DEC7/RLU-Project/target/generated-sources/annotations/rlu/benchmarks/jmh_generated/LockFreeSetBenchmark_MyState_jmhType_B3.java", "Java", 0, 19, 0, 0, 2, 21
"/Users/ali/cs5510/Group-Project-5510/RLU-Project-DEC7/RLU-Project/target/generated-sources/annotations/rlu/benchmarks/jmh_generated/LockFreeSetBenchmark_g16for20_jmhTest.java", "Java", 0, 1652, 0, 0, 65, 1717
"/Users/ali/cs5510/Group-Project-5510/RLU-Project-DEC7/RLU-Project/target/generated-sources/annotations/rlu/benchmarks/jmh_generated/LockFreeSetBenchmark_g16for40_jmhTest.java", "Java", 0, 1652, 0, 0, 65, 1717
"/Users/ali/cs5510/Group-Project-5510/RLU-Project-DEC7/RLU-Project/target/generated-sources/annotations/rlu/benchmarks/jmh_generated/LockFreeSetBenchmark_g16for60_jmhTest.java", "Java", 0, 1652, 0, 0, 65, 1717
"/Users/ali/cs5510/Group-Project-5510/RLU-Project-DEC7/RLU-Project/target/generated-sources/annotations/rlu/benchmarks/jmh_generated/LockFreeSetBenchmark_g16for80_jmhTest.java", "Java", 0, 1652, 0, 0, 65, 1717
"/Users/ali/cs5510/Group-Project-5510/RLU-Project-DEC7/RLU-Project/target/generated-sources/annotations/rlu/benchmarks/jmh_generated/LockFreeSetBenchmark_g24for20_jmhTest.java", "Java", 0, 1652, 0, 0, 65, 1717
"/Users/ali/cs5510/Group-Project-5510/RLU-Project-DEC7/RLU-Project/target/generated-sources/annotations/rlu/benchmarks/jmh_generated/LockFreeSetBenchmark_g24for40_jmhTest.java", "Java", 0, 1652, 0, 0, 65, 1717
"/Users/ali/cs5510/Group-Project-5510/RLU-Project-DEC7/RLU-Project/target/generated-sources/annotations/rlu/benchmarks/jmh_generated/LockFreeSetBenchmark_g24for60_jmhTest.java", "Java", 0, 1652, 0, 0, 65, 1717
"/Users/ali/cs5510/Group-Project-5510/RLU-Project-DEC7/RLU-Project/target/generated-sources/annotations/rlu/benchmarks/jmh_generated/LockFreeSetBenchmark_g24for80_jmhTest.java", "Java", 0, 1652, 0, 0, 65, 1717
"/Users/ali/cs5510/Group-Project-5510/RLU-Project-DEC7/RLU-Project/target/generated-sources/annotations/rlu/benchmarks/jmh_generated/LockFreeSetBenchmark_g32for20_jmhTest.java", "Java", 0, 1652, 0, 0, 65, 1717
"/Users/ali/cs5510/Group-Project-5510/RLU-Project-DEC7/RLU-Project/target/generated-sources/annotations/rlu/benchmarks/jmh_generated/LockFreeSetBenchmark_g32for40_jmhTest.java", "Java", 0, 1652, 0, 0, 65, 1717
"/Users/ali/cs5510/Group-Project-5510/RLU-Project-DEC7/RLU-Project/target/generated-sources/annotations/rlu/benchmarks/jmh_generated/LockFreeSetBenchmark_g32for60_jmhTest.java", "Java", 0, 1652, 0, 0, 65, 1717
"/Users/ali/cs5510/Group-Project-5510/RLU-Project-DEC7/RLU-Project/target/generated-sources/annotations/rlu/benchmarks/jmh_generated/LockFreeSetBenchmark_g32for80_jmhTest.java", "Java", 0, 1652, 0, 0, 65, 1717
"/Users/ali/cs5510/Group-Project-5510/RLU-Project-DEC7/RLU-Project/target/generated-sources/annotations/rlu/benchmarks/jmh_generated/LockFreeSetBenchmark_g8for20_jmhTest.java", "Java", 0, 1652, 0, 0, 65, 1717
"/Users/ali/cs5510/Group-Project-5510/RLU-Project-DEC7/RLU-Project/target/generated-sources/annotations/rlu/benchmarks/jmh_generated/LockFreeSetBenchmark_g8for40_jmhTest.java", "Java", 0, 1652, 0, 0, 65, 1717
"/Users/ali/cs5510/Group-Project-5510/RLU-Project-DEC7/RLU-Project/target/generated-sources/annotations/rlu/benchmarks/jmh_generated/LockFreeSetBenchmark_g8for60_jmhTest.java", "Java", 0, 1652, 0, 0, 65, 1717
"/Users/ali/cs5510/Group-Project-5510/RLU-Project-DEC7/RLU-Project/target/generated-sources/annotations/rlu/benchmarks/jmh_generated/LockFreeSetBenchmark_g8for80_jmhTest.java", "Java", 0, 1652, 0, 0, 65, 1717
"/Users/ali/cs5510/Group-Project-5510/RLU-Project-DEC7/RLU-Project/target/generated-sources/annotations/rlu/benchmarks/jmh_generated/LockFreeSetBenchmark_jmhType.java", "Java", 0, 3, 0, 0, 2, 5
"/Users/ali/cs5510/Group-Project-5510/RLU-Project-DEC7/RLU-Project/target/generated-sources/annotations/rlu/benchmarks/jmh_generated/LockFreeSetBenchmark_jmhType_B1.java", "Java", 0, 20, 0, 0, 1, 21
"/Users/ali/cs5510/Group-Project-5510/RLU-Project-DEC7/RLU-Project/target/generated-sources/annotations/rlu/benchmarks/jmh_generated/LockFreeSetBenchmark_jmhType_B2.java", "Java", 0, 19, 0, 0, 4, 23
"/Users/ali/cs5510/Group-Project-5510/RLU-Project-DEC7/RLU-Project/target/generated-sources/annotations/rlu/benchmarks/jmh_generated/LockFreeSetBenchmark_jmhType_B3.java", "Java", 0, 19, 0, 0, 2, 21
"/Users/ali/cs5510/Group-Project-5510/RLU-Project-DEC7/RLU-Project/target/generated-sources/annotations/rlu/benchmarks/jmh_generated/RluCGPaddedSetBenchmark_GlobalState_jmhType.java", "Java", 0, 3, 0, 0, 2, 5
"/Users/ali/cs5510/Group-Project-5510/RLU-Project-DEC7/RLU-Project/target/generated-sources/annotations/rlu/benchmarks/jmh_generated/RluCGPaddedSetBenchmark_GlobalState_jmhType_B1.java", "Java", 0, 20, 0, 0, 1, 21
"/Users/ali/cs5510/Group-Project-5510/RLU-Project-DEC7/RLU-Project/target/generated-sources/annotations/rlu/benchmarks/jmh_generated/RluCGPaddedSetBenchmark_GlobalState_jmhType_B2.java", "Java", 0, 19, 0, 0, 4, 23
"/Users/ali/cs5510/Group-Project-5510/RLU-Project-DEC7/RLU-Project/target/generated-sources/annotations/rlu/benchmarks/jmh_generated/RluCGPaddedSetBenchmark_GlobalState_jmhType_B3.java", "Java", 0, 19, 0, 0, 2, 21
"/Users/ali/cs5510/Group-Project-5510/RLU-Project-DEC7/RLU-Project/target/generated-sources/annotations/rlu/benchmarks/jmh_generated/RluCGPaddedSetBenchmark_ThreadState_jmhType.java", "Java", 0, 3, 0, 0, 2, 5
"/Users/ali/cs5510/Group-Project-5510/RLU-Project-DEC7/RLU-Project/target/generated-sources/annotations/rlu/benchmarks/jmh_generated/RluCGPaddedSetBenchmark_ThreadState_jmhType_B1.java", "Java", 0, 20, 0, 0, 1, 21
"/Users/ali/cs5510/Group-Project-5510/RLU-Project-DEC7/RLU-Project/target/generated-sources/annotations/rlu/benchmarks/jmh_generated/RluCGPaddedSetBenchmark_ThreadState_jmhType_B2.java", "Java", 0, 16, 0, 0, 4, 20
"/Users/ali/cs5510/Group-Project-5510/RLU-Project-DEC7/RLU-Project/target/generated-sources/annotations/rlu/benchmarks/jmh_generated/RluCGPaddedSetBenchmark_ThreadState_jmhType_B3.java", "Java", 0, 19, 0, 0, 2, 21
"/Users/ali/cs5510/Group-Project-5510/RLU-Project-DEC7/RLU-Project/target/generated-sources/annotations/rlu/benchmarks/jmh_generated/RluCGPaddedSetBenchmark_g16for20_jmhTest.java", "Java", 0, 1726, 0, 0, 69, 1795
"/Users/ali/cs5510/Group-Project-5510/RLU-Project-DEC7/RLU-Project/target/generated-sources/annotations/rlu/benchmarks/jmh_generated/RluCGPaddedSetBenchmark_g16for40_jmhTest.java", "Java", 0, 1726, 0, 0, 69, 1795
"/Users/ali/cs5510/Group-Project-5510/RLU-Project-DEC7/RLU-Project/target/generated-sources/annotations/rlu/benchmarks/jmh_generated/RluCGPaddedSetBenchmark_g16for60_jmhTest.java", "Java", 0, 1726, 0, 0, 69, 1795
"/Users/ali/cs5510/Group-Project-5510/RLU-Project-DEC7/RLU-Project/target/generated-sources/annotations/rlu/benchmarks/jmh_generated/RluCGPaddedSetBenchmark_g16for80_jmhTest.java", "Java", 0, 1726, 0, 0, 69, 1795
"/Users/ali/cs5510/Group-Project-5510/RLU-Project-DEC7/RLU-Project/target/generated-sources/annotations/rlu/benchmarks/jmh_generated/RluCGPaddedSetBenchmark_g24for20_jmhTest.java", "Java", 0, 1726, 0, 0, 69, 1795
"/Users/ali/cs5510/Group-Project-5510/RLU-Project-DEC7/RLU-Project/target/generated-sources/annotations/rlu/benchmarks/jmh_generated/RluCGPaddedSetBenchmark_g24for40_jmhTest.java", "Java", 0, 1726, 0, 0, 69, 1795
"/Users/ali/cs5510/Group-Project-5510/RLU-Project-DEC7/RLU-Project/target/generated-sources/annotations/rlu/benchmarks/jmh_generated/RluCGPaddedSetBenchmark_g24for60_jmhTest.java", "Java", 0, 1726, 0, 0, 69, 1795
"/Users/ali/cs5510/Group-Project-5510/RLU-Project-DEC7/RLU-Project/target/generated-sources/annotations/rlu/benchmarks/jmh_generated/RluCGPaddedSetBenchmark_g24for80_jmhTest.java", "Java", 0, 1726, 0, 0, 69, 1795
"/Users/ali/cs5510/Group-Project-5510/RLU-Project-DEC7/RLU-Project/target/generated-sources/annotations/rlu/benchmarks/jmh_generated/RluCGPaddedSetBenchmark_g32for20_jmhTest.java", "Java", 0, 1726, 0, 0, 69, 1795
"/Users/ali/cs5510/Group-Project-5510/RLU-Project-DEC7/RLU-Project/target/generated-sources/annotations/rlu/benchmarks/jmh_generated/RluCGPaddedSetBenchmark_g32for40_jmhTest.java", "Java", 0, 1726, 0, 0, 69, 1795
"/Users/ali/cs5510/Group-Project-5510/RLU-Project-DEC7/RLU-Project/target/generated-sources/annotations/rlu/benchmarks/jmh_generated/RluCGPaddedSetBenchmark_g32for60_jmhTest.java", "Java", 0, 1726, 0, 0, 69, 1795
"/Users/ali/cs5510/Group-Project-5510/RLU-Project-DEC7/RLU-Project/target/generated-sources/annotations/rlu/benchmarks/jmh_generated/RluCGPaddedSetBenchmark_g32for80_jmhTest.java", "Java", 0, 1726, 0, 0, 69, 1795
"/Users/ali/cs5510/Group-Project-5510/RLU-Project-DEC7/RLU-Project/target/generated-sources/annotations/rlu/benchmarks/jmh_generated/RluCGPaddedSetBenchmark_g8for20_jmhTest.java", "Java", 0, 1726, 0, 0, 69, 1795
"/Users/ali/cs5510/Group-Project-5510/RLU-Project-DEC7/RLU-Project/target/generated-sources/annotations/rlu/benchmarks/jmh_generated/RluCGPaddedSetBenchmark_g8for40_jmhTest.java", "Java", 0, 1726, 0, 0, 69, 1795
"/Users/ali/cs5510/Group-Project-5510/RLU-Project-DEC7/RLU-Project/target/generated-sources/annotations/rlu/benchmarks/jmh_generated/RluCGPaddedSetBenchmark_g8for60_jmhTest.java", "Java", 0, 1726, 0, 0, 69, 1795
"/Users/ali/cs5510/Group-Project-5510/RLU-Project-DEC7/RLU-Project/target/generated-sources/annotations/rlu/benchmarks/jmh_generated/RluCGPaddedSetBenchmark_g8for80_jmhTest.java", "Java", 0, 1726, 0, 0, 69, 1795
"/Users/ali/cs5510/Group-Project-5510/RLU-Project-DEC7/RLU-Project/target/generated-sources/annotations/rlu/benchmarks/jmh_generated/RluCGPaddedSetBenchmark_jmhType.java", "Java", 0, 3, 0, 0, 2, 5
"/Users/ali/cs5510/Group-Project-5510/RLU-Project-DEC7/RLU-Project/target/generated-sources/annotations/rlu/benchmarks/jmh_generated/RluCGPaddedSetBenchmark_jmhType_B1.java", "Java", 0, 20, 0, 0, 1, 21
"/Users/ali/cs5510/Group-Project-5510/RLU-Project-DEC7/RLU-Project/target/generated-sources/annotations/rlu/benchmarks/jmh_generated/RluCGPaddedSetBenchmark_jmhType_B2.java", "Java", 0, 19, 0, 0, 4, 23
"/Users/ali/cs5510/Group-Project-5510/RLU-Project-DEC7/RLU-Project/target/generated-sources/annotations/rlu/benchmarks/jmh_generated/RluCGPaddedSetBenchmark_jmhType_B3.java", "Java", 0, 19, 0, 0, 2, 21
"/Users/ali/cs5510/Group-Project-5510/RLU-Project-DEC7/RLU-Project/target/generated-sources/annotations/rlu/benchmarks/jmh_generated/RluCGSetBenchmark_GlobalState_jmhType.java", "Java", 0, 3, 0, 0, 2, 5
"/Users/ali/cs5510/Group-Project-5510/RLU-Project-DEC7/RLU-Project/target/generated-sources/annotations/rlu/benchmarks/jmh_generated/RluCGSetBenchmark_GlobalState_jmhType_B1.java", "Java", 0, 20, 0, 0, 1, 21
"/Users/ali/cs5510/Group-Project-5510/RLU-Project-DEC7/RLU-Project/target/generated-sources/annotations/rlu/benchmarks/jmh_generated/RluCGSetBenchmark_GlobalState_jmhType_B2.java", "Java", 0, 19, 0, 0, 4, 23
"/Users/ali/cs5510/Group-Project-5510/RLU-Project-DEC7/RLU-Project/target/generated-sources/annotations/rlu/benchmarks/jmh_generated/RluCGSetBenchmark_GlobalState_jmhType_B3.java", "Java", 0, 19, 0, 0, 2, 21
"/Users/ali/cs5510/Group-Project-5510/RLU-Project-DEC7/RLU-Project/target/generated-sources/annotations/rlu/benchmarks/jmh_generated/RluCGSetBenchmark_ThreadState_jmhType.java", "Java", 0, 3, 0, 0, 2, 5
"/Users/ali/cs5510/Group-Project-5510/RLU-Project-DEC7/RLU-Project/target/generated-sources/annotations/rlu/benchmarks/jmh_generated/RluCGSetBenchmark_ThreadState_jmhType_B1.java", "Java", 0, 20, 0, 0, 1, 21
"/Users/ali/cs5510/Group-Project-5510/RLU-Project-DEC7/RLU-Project/target/generated-sources/annotations/rlu/benchmarks/jmh_generated/RluCGSetBenchmark_ThreadState_jmhType_B2.java", "Java", 0, 16, 0, 0, 4, 20
"/Users/ali/cs5510/Group-Project-5510/RLU-Project-DEC7/RLU-Project/target/generated-sources/annotations/rlu/benchmarks/jmh_generated/RluCGSetBenchmark_ThreadState_jmhType_B3.java", "Java", 0, 19, 0, 0, 2, 21
"/Users/ali/cs5510/Group-Project-5510/RLU-Project-DEC7/RLU-Project/target/generated-sources/annotations/rlu/benchmarks/jmh_generated/RluCGSetBenchmark_g16for20_jmhTest.java", "Java", 0, 1726, 0, 0, 69, 1795
"/Users/ali/cs5510/Group-Project-5510/RLU-Project-DEC7/RLU-Project/target/generated-sources/annotations/rlu/benchmarks/jmh_generated/RluCGSetBenchmark_g16for40_jmhTest.java", "Java", 0, 1726, 0, 0, 69, 1795
"/Users/ali/cs5510/Group-Project-5510/RLU-Project-DEC7/RLU-Project/target/generated-sources/annotations/rlu/benchmarks/jmh_generated/RluCGSetBenchmark_g16for60_jmhTest.java", "Java", 0, 1726, 0, 0, 69, 1795
"/Users/ali/cs5510/Group-Project-5510/RLU-Project-DEC7/RLU-Project/target/generated-sources/annotations/rlu/benchmarks/jmh_generated/RluCGSetBenchmark_g16for80_jmhTest.java", "Java", 0, 1726, 0, 0, 69, 1795
"/Users/ali/cs5510/Group-Project-5510/RLU-Project-DEC7/RLU-Project/target/generated-sources/annotations/rlu/benchmarks/jmh_generated/RluCGSetBenchmark_g24for20_jmhTest.java", "Java", 0, 1726, 0, 0, 69, 1795
"/Users/ali/cs5510/Group-Project-5510/RLU-Project-DEC7/RLU-Project/target/generated-sources/annotations/rlu/benchmarks/jmh_generated/RluCGSetBenchmark_g24for40_jmhTest.java", "Java", 0, 1726, 0, 0, 69, 1795
"/Users/ali/cs5510/Group-Project-5510/RLU-Project-DEC7/RLU-Project/target/generated-sources/annotations/rlu/benchmarks/jmh_generated/RluCGSetBenchmark_g24for60_jmhTest.java", "Java", 0, 1726, 0, 0, 69, 1795
"/Users/ali/cs5510/Group-Project-5510/RLU-Project-DEC7/RLU-Project/target/generated-sources/annotations/rlu/benchmarks/jmh_generated/RluCGSetBenchmark_g24for80_jmhTest.java", "Java", 0, 1726, 0, 0, 69, 1795
"/Users/ali/cs5510/Group-Project-5510/RLU-Project-DEC7/RLU-Project/target/generated-sources/annotations/rlu/benchmarks/jmh_generated/RluCGSetBenchmark_g32for20_jmhTest.java", "Java", 0, 1726, 0, 0, 69, 1795
"/Users/ali/cs5510/Group-Project-5510/RLU-Project-DEC7/RLU-Project/target/generated-sources/annotations/rlu/benchmarks/jmh_generated/RluCGSetBenchmark_g32for40_jmhTest.java", "Java", 0, 1726, 0, 0, 69, 1795
"/Users/ali/cs5510/Group-Project-5510/RLU-Project-DEC7/RLU-Project/target/generated-sources/annotations/rlu/benchmarks/jmh_generated/RluCGSetBenchmark_g32for60_jmhTest.java", "Java", 0, 1726, 0, 0, 69, 1795
"/Users/ali/cs5510/Group-Project-5510/RLU-Project-DEC7/RLU-Project/target/generated-sources/annotations/rlu/benchmarks/jmh_generated/RluCGSetBenchmark_g32for80_jmhTest.java", "Java", 0, 1726, 0, 0, 69, 1795
"/Users/ali/cs5510/Group-Project-5510/RLU-Project-DEC7/RLU-Project/target/generated-sources/annotations/rlu/benchmarks/jmh_generated/RluCGSetBenchmark_g8for20_jmhTest.java", "Java", 0, 1726, 0, 0, 69, 1795
"/Users/ali/cs5510/Group-Project-5510/RLU-Project-DEC7/RLU-Project/target/generated-sources/annotations/rlu/benchmarks/jmh_generated/RluCGSetBenchmark_g8for40_jmhTest.java", "Java", 0, 1726, 0, 0, 69, 1795
"/Users/ali/cs5510/Group-Project-5510/RLU-Project-DEC7/RLU-Project/target/generated-sources/annotations/rlu/benchmarks/jmh_generated/RluCGSetBenchmark_g8for60_jmhTest.java", "Java", 0, 1726, 0, 0, 69, 1795
"/Users/ali/cs5510/Group-Project-5510/RLU-Project-DEC7/RLU-Project/target/generated-sources/annotations/rlu/benchmarks/jmh_generated/RluCGSetBenchmark_g8for80_jmhTest.java", "Java", 0, 1726, 0, 0, 69, 1795
"/Users/ali/cs5510/Group-Project-5510/RLU-Project-DEC7/RLU-Project/target/generated-sources/annotations/rlu/benchmarks/jmh_generated/RluCGSetBenchmark_jmhType.java", "Java", 0, 3, 0, 0, 2, 5
"/Users/ali/cs5510/Group-Project-5510/RLU-Project-DEC7/RLU-Project/target/generated-sources/annotations/rlu/benchmarks/jmh_generated/RluCGSetBenchmark_jmhType_B1.java", "Java", 0, 20, 0, 0, 1, 21
"/Users/ali/cs5510/Group-Project-5510/RLU-Project-DEC7/RLU-Project/target/generated-sources/annotations/rlu/benchmarks/jmh_generated/RluCGSetBenchmark_jmhType_B2.java", "Java", 0, 19, 0, 0, 4, 23
"/Users/ali/cs5510/Group-Project-5510/RLU-Project-DEC7/RLU-Project/target/generated-sources/annotations/rlu/benchmarks/jmh_generated/RluCGSetBenchmark_jmhType_B3.java", "Java", 0, 19, 0, 0, 2, 21
"/Users/ali/cs5510/Group-Project-5510/RLU-Project-DEC7/RLU-Project/target/generated-sources/annotations/rlu/benchmarks/jmh_generated/RluCoarseBSTBenchmark_GlobalState_jmhType.java", "Java", 0, 3, 0, 0, 2, 5
"/Users/ali/cs5510/Group-Project-5510/RLU-Project-DEC7/RLU-Project/target/generated-sources/annotations/rlu/benchmarks/jmh_generated/RluCoarseBSTBenchmark_GlobalState_jmhType_B1.java", "Java", 0, 20, 0, 0, 1, 21
"/Users/ali/cs5510/Group-Project-5510/RLU-Project-DEC7/RLU-Project/target/generated-sources/annotations/rlu/benchmarks/jmh_generated/RluCoarseBSTBenchmark_GlobalState_jmhType_B2.java", "Java", 0, 19, 0, 0, 4, 23
"/Users/ali/cs5510/Group-Project-5510/RLU-Project-DEC7/RLU-Project/target/generated-sources/annotations/rlu/benchmarks/jmh_generated/RluCoarseBSTBenchmark_GlobalState_jmhType_B3.java", "Java", 0, 19, 0, 0, 2, 21
"/Users/ali/cs5510/Group-Project-5510/RLU-Project-DEC7/RLU-Project/target/generated-sources/annotations/rlu/benchmarks/jmh_generated/RluCoarseBSTBenchmark_ThreadState_jmhType.java", "Java", 0, 3, 0, 0, 2, 5
"/Users/ali/cs5510/Group-Project-5510/RLU-Project-DEC7/RLU-Project/target/generated-sources/annotations/rlu/benchmarks/jmh_generated/RluCoarseBSTBenchmark_ThreadState_jmhType_B1.java", "Java", 0, 20, 0, 0, 1, 21
"/Users/ali/cs5510/Group-Project-5510/RLU-Project-DEC7/RLU-Project/target/generated-sources/annotations/rlu/benchmarks/jmh_generated/RluCoarseBSTBenchmark_ThreadState_jmhType_B2.java", "Java", 0, 16, 0, 0, 4, 20
"/Users/ali/cs5510/Group-Project-5510/RLU-Project-DEC7/RLU-Project/target/generated-sources/annotations/rlu/benchmarks/jmh_generated/RluCoarseBSTBenchmark_ThreadState_jmhType_B3.java", "Java", 0, 19, 0, 0, 2, 21
"/Users/ali/cs5510/Group-Project-5510/RLU-Project-DEC7/RLU-Project/target/generated-sources/annotations/rlu/benchmarks/jmh_generated/RluCoarseBSTBenchmark_g16for20_jmhTest.java", "Java", 0, 1726, 0, 0, 69, 1795
"/Users/ali/cs5510/Group-Project-5510/RLU-Project-DEC7/RLU-Project/target/generated-sources/annotations/rlu/benchmarks/jmh_generated/RluCoarseBSTBenchmark_g16for40_jmhTest.java", "Java", 0, 1726, 0, 0, 69, 1795
"/Users/ali/cs5510/Group-Project-5510/RLU-Project-DEC7/RLU-Project/target/generated-sources/annotations/rlu/benchmarks/jmh_generated/RluCoarseBSTBenchmark_g16for60_jmhTest.java", "Java", 0, 1726, 0, 0, 69, 1795
"/Users/ali/cs5510/Group-Project-5510/RLU-Project-DEC7/RLU-Project/target/generated-sources/annotations/rlu/benchmarks/jmh_generated/RluCoarseBSTBenchmark_g16for80_jmhTest.java", "Java", 0, 1726, 0, 0, 69, 1795
"/Users/ali/cs5510/Group-Project-5510/RLU-Project-DEC7/RLU-Project/target/generated-sources/annotations/rlu/benchmarks/jmh_generated/RluCoarseBSTBenchmark_g24for20_jmhTest.java", "Java", 0, 1726, 0, 0, 69, 1795
"/Users/ali/cs5510/Group-Project-5510/RLU-Project-DEC7/RLU-Project/target/generated-sources/annotations/rlu/benchmarks/jmh_generated/RluCoarseBSTBenchmark_g24for40_jmhTest.java", "Java", 0, 1726, 0, 0, 69, 1795
"/Users/ali/cs5510/Group-Project-5510/RLU-Project-DEC7/RLU-Project/target/generated-sources/annotations/rlu/benchmarks/jmh_generated/RluCoarseBSTBenchmark_g24for60_jmhTest.java", "Java", 0, 1726, 0, 0, 69, 1795
"/Users/ali/cs5510/Group-Project-5510/RLU-Project-DEC7/RLU-Project/target/generated-sources/annotations/rlu/benchmarks/jmh_generated/RluCoarseBSTBenchmark_g24for80_jmhTest.java", "Java", 0, 1726, 0, 0, 69, 1795
"/Users/ali/cs5510/Group-Project-5510/RLU-Project-DEC7/RLU-Project/target/generated-sources/annotations/rlu/benchmarks/jmh_generated/RluCoarseBSTBenchmark_g32for20_jmhTest.java", "Java", 0, 1726, 0, 0, 69, 1795
"/Users/ali/cs5510/Group-Project-5510/RLU-Project-DEC7/RLU-Project/target/generated-sources/annotations/rlu/benchmarks/jmh_generated/RluCoarseBSTBenchmark_g32for40_jmhTest.java", "Java", 0, 1726, 0, 0, 69, 1795
"/Users/ali/cs5510/Group-Project-5510/RLU-Project-DEC7/RLU-Project/target/generated-sources/annotations/rlu/benchmarks/jmh_generated/RluCoarseBSTBenchmark_g32for60_jmhTest.java", "Java", 0, 1726, 0, 0, 69, 1795
"/Users/ali/cs5510/Group-Project-5510/RLU-Project-DEC7/RLU-Project/target/generated-sources/annotations/rlu/benchmarks/jmh_generated/RluCoarseBSTBenchmark_g32for80_jmhTest.java", "Java", 0, 1726, 0, 0, 69, 1795
"/Users/ali/cs5510/Group-Project-5510/RLU-Project-DEC7/RLU-Project/target/generated-sources/annotations/rlu/benchmarks/jmh_generated/RluCoarseBSTBenchmark_g8for20_jmhTest.java", "Java", 0, 1726, 0, 0, 69, 1795
"/Users/ali/cs5510/Group-Project-5510/RLU-Project-DEC7/RLU-Project/target/generated-sources/annotations/rlu/benchmarks/jmh_generated/RluCoarseBSTBenchmark_g8for40_jmhTest.java", "Java", 0, 1726, 0, 0, 69, 1795
"/Users/ali/cs5510/Group-Project-5510/RLU-Project-DEC7/RLU-Project/target/generated-sources/annotations/rlu/benchmarks/jmh_generated/RluCoarseBSTBenchmark_g8for60_jmhTest.java", "Java", 0, 1726, 0, 0, 69, 1795
"/Users/ali/cs5510/Group-Project-5510/RLU-Project-DEC7/RLU-Project/target/generated-sources/annotations/rlu/benchmarks/jmh_generated/RluCoarseBSTBenchmark_g8for80_jmhTest.java", "Java", 0, 1726, 0, 0, 69, 1795
"/Users/ali/cs5510/Group-Project-5510/RLU-Project-DEC7/RLU-Project/target/generated-sources/annotations/rlu/benchmarks/jmh_generated/RluCoarseBSTBenchmark_jmhType.java", "Java", 0, 3, 0, 0, 2, 5
"/Users/ali/cs5510/Group-Project-5510/RLU-Project-DEC7/RLU-Project/target/generated-sources/annotations/rlu/benchmarks/jmh_generated/RluCoarseBSTBenchmark_jmhType_B1.java", "Java", 0, 20, 0, 0, 1, 21
"/Users/ali/cs5510/Group-Project-5510/RLU-Project-DEC7/RLU-Project/target/generated-sources/annotations/rlu/benchmarks/jmh_generated/RluCoarseBSTBenchmark_jmhType_B2.java", "Java", 0, 19, 0, 0, 4, 23
"/Users/ali/cs5510/Group-Project-5510/RLU-Project-DEC7/RLU-Project/target/generated-sources/annotations/rlu/benchmarks/jmh_generated/RluCoarseBSTBenchmark_jmhType_B3.java", "Java", 0, 19, 0, 0, 2, 21
"/Users/ali/cs5510/Group-Project-5510/RLU-Project-DEC7/RLU-Project/target/generated-sources/annotations/rlu/benchmarks/jmh_generated/RluFGSetBenchmark_GlobalState_jmhType.java", "Java", 0, 3, 0, 0, 2, 5
"/Users/ali/cs5510/Group-Project-5510/RLU-Project-DEC7/RLU-Project/target/generated-sources/annotations/rlu/benchmarks/jmh_generated/RluFGSetBenchmark_GlobalState_jmhType_B1.java", "Java", 0, 20, 0, 0, 1, 21
"/Users/ali/cs5510/Group-Project-5510/RLU-Project-DEC7/RLU-Project/target/generated-sources/annotations/rlu/benchmarks/jmh_generated/RluFGSetBenchmark_GlobalState_jmhType_B2.java", "Java", 0, 19, 0, 0, 4, 23
"/Users/ali/cs5510/Group-Project-5510/RLU-Project-DEC7/RLU-Project/target/generated-sources/annotations/rlu/benchmarks/jmh_generated/RluFGSetBenchmark_GlobalState_jmhType_B3.java", "Java", 0, 19, 0, 0, 2, 21
"/Users/ali/cs5510/Group-Project-5510/RLU-Project-DEC7/RLU-Project/target/generated-sources/annotations/rlu/benchmarks/jmh_generated/RluFGSetBenchmark_ThreadState_jmhType.java", "Java", 0, 3, 0, 0, 2, 5
"/Users/ali/cs5510/Group-Project-5510/RLU-Project-DEC7/RLU-Project/target/generated-sources/annotations/rlu/benchmarks/jmh_generated/RluFGSetBenchmark_ThreadState_jmhType_B1.java", "Java", 0, 20, 0, 0, 1, 21
"/Users/ali/cs5510/Group-Project-5510/RLU-Project-DEC7/RLU-Project/target/generated-sources/annotations/rlu/benchmarks/jmh_generated/RluFGSetBenchmark_ThreadState_jmhType_B2.java", "Java", 0, 16, 0, 0, 4, 20
"/Users/ali/cs5510/Group-Project-5510/RLU-Project-DEC7/RLU-Project/target/generated-sources/annotations/rlu/benchmarks/jmh_generated/RluFGSetBenchmark_ThreadState_jmhType_B3.java", "Java", 0, 19, 0, 0, 2, 21
"/Users/ali/cs5510/Group-Project-5510/RLU-Project-DEC7/RLU-Project/target/generated-sources/annotations/rlu/benchmarks/jmh_generated/RluFGSetBenchmark_g16for20_jmhTest.java", "Java", 0, 1726, 0, 0, 69, 1795
"/Users/ali/cs5510/Group-Project-5510/RLU-Project-DEC7/RLU-Project/target/generated-sources/annotations/rlu/benchmarks/jmh_generated/RluFGSetBenchmark_g16for40_jmhTest.java", "Java", 0, 1726, 0, 0, 69, 1795
"/Users/ali/cs5510/Group-Project-5510/RLU-Project-DEC7/RLU-Project/target/generated-sources/annotations/rlu/benchmarks/jmh_generated/RluFGSetBenchmark_g16for60_jmhTest.java", "Java", 0, 1726, 0, 0, 69, 1795
"/Users/ali/cs5510/Group-Project-5510/RLU-Project-DEC7/RLU-Project/target/generated-sources/annotations/rlu/benchmarks/jmh_generated/RluFGSetBenchmark_g16for80_jmhTest.java", "Java", 0, 1726, 0, 0, 69, 1795
"/Users/ali/cs5510/Group-Project-5510/RLU-Project-DEC7/RLU-Project/target/generated-sources/annotations/rlu/benchmarks/jmh_generated/RluFGSetBenchmark_g24for20_jmhTest.java", "Java", 0, 1726, 0, 0, 69, 1795
"/Users/ali/cs5510/Group-Project-5510/RLU-Project-DEC7/RLU-Project/target/generated-sources/annotations/rlu/benchmarks/jmh_generated/RluFGSetBenchmark_g24for40_jmhTest.java", "Java", 0, 1726, 0, 0, 69, 1795
"/Users/ali/cs5510/Group-Project-5510/RLU-Project-DEC7/RLU-Project/target/generated-sources/annotations/rlu/benchmarks/jmh_generated/RluFGSetBenchmark_g24for60_jmhTest.java", "Java", 0, 1726, 0, 0, 69, 1795
"/Users/ali/cs5510/Group-Project-5510/RLU-Project-DEC7/RLU-Project/target/generated-sources/annotations/rlu/benchmarks/jmh_generated/RluFGSetBenchmark_g24for80_jmhTest.java", "Java", 0, 1726, 0, 0, 69, 1795
"/Users/ali/cs5510/Group-Project-5510/RLU-Project-DEC7/RLU-Project/target/generated-sources/annotations/rlu/benchmarks/jmh_generated/RluFGSetBenchmark_g32for20_jmhTest.java", "Java", 0, 1726, 0, 0, 69, 1795
"/Users/ali/cs5510/Group-Project-5510/RLU-Project-DEC7/RLU-Project/target/generated-sources/annotations/rlu/benchmarks/jmh_generated/RluFGSetBenchmark_g32for40_jmhTest.java", "Java", 0, 1726, 0, 0, 69, 1795
"/Users/ali/cs5510/Group-Project-5510/RLU-Project-DEC7/RLU-Project/target/generated-sources/annotations/rlu/benchmarks/jmh_generated/RluFGSetBenchmark_g32for60_jmhTest.java", "Java", 0, 1726, 0, 0, 69, 1795
"/Users/ali/cs5510/Group-Project-5510/RLU-Project-DEC7/RLU-Project/target/generated-sources/annotations/rlu/benchmarks/jmh_generated/RluFGSetBenchmark_g32for80_jmhTest.java", "Java", 0, 1726, 0, 0, 69, 1795
"/Users/ali/cs5510/Group-Project-5510/RLU-Project-DEC7/RLU-Project/target/generated-sources/annotations/rlu/benchmarks/jmh_generated/RluFGSetBenchmark_g8for20_jmhTest.java", "Java", 0, 1726, 0, 0, 69, 1795
"/Users/ali/cs5510/Group-Project-5510/RLU-Project-DEC7/RLU-Project/target/generated-sources/annotations/rlu/benchmarks/jmh_generated/RluFGSetBenchmark_g8for40_jmhTest.java", "Java", 0, 1726, 0, 0, 69, 1795
"/Users/ali/cs5510/Group-Project-5510/RLU-Project-DEC7/RLU-Project/target/generated-sources/annotations/rlu/benchmarks/jmh_generated/RluFGSetBenchmark_g8for60_jmhTest.java", "Java", 0, 1726, 0, 0, 69, 1795
"/Users/ali/cs5510/Group-Project-5510/RLU-Project-DEC7/RLU-Project/target/generated-sources/annotations/rlu/benchmarks/jmh_generated/RluFGSetBenchmark_g8for80_jmhTest.java", "Java", 0, 1726, 0, 0, 69, 1795
"/Users/ali/cs5510/Group-Project-5510/RLU-Project-DEC7/RLU-Project/target/generated-sources/annotations/rlu/benchmarks/jmh_generated/RluFGSetBenchmark_jmhType.java", "Java", 0, 3, 0, 0, 2, 5
"/Users/ali/cs5510/Group-Project-5510/RLU-Project-DEC7/RLU-Project/target/generated-sources/annotations/rlu/benchmarks/jmh_generated/RluFGSetBenchmark_jmhType_B1.java", "Java", 0, 20, 0, 0, 1, 21
"/Users/ali/cs5510/Group-Project-5510/RLU-Project-DEC7/RLU-Project/target/generated-sources/annotations/rlu/benchmarks/jmh_generated/RluFGSetBenchmark_jmhType_B2.java", "Java", 0, 19, 0, 0, 4, 23
"/Users/ali/cs5510/Group-Project-5510/RLU-Project-DEC7/RLU-Project/target/generated-sources/annotations/rlu/benchmarks/jmh_generated/RluFGSetBenchmark_jmhType_B3.java", "Java", 0, 19, 0, 0, 2, 21
"/Users/ali/cs5510/Group-Project-5510/RLU-Project-DEC7/RLU-Project/target/generated-sources/annotations/rlu/benchmarks/jmh_generated/RluFineBSTBenchmark_GlobalState_jmhType.java", "Java", 0, 3, 0, 0, 2, 5
"/Users/ali/cs5510/Group-Project-5510/RLU-Project-DEC7/RLU-Project/target/generated-sources/annotations/rlu/benchmarks/jmh_generated/RluFineBSTBenchmark_GlobalState_jmhType_B1.java", "Java", 0, 20, 0, 0, 1, 21
"/Users/ali/cs5510/Group-Project-5510/RLU-Project-DEC7/RLU-Project/target/generated-sources/annotations/rlu/benchmarks/jmh_generated/RluFineBSTBenchmark_GlobalState_jmhType_B2.java", "Java", 0, 19, 0, 0, 4, 23
"/Users/ali/cs5510/Group-Project-5510/RLU-Project-DEC7/RLU-Project/target/generated-sources/annotations/rlu/benchmarks/jmh_generated/RluFineBSTBenchmark_GlobalState_jmhType_B3.java", "Java", 0, 19, 0, 0, 2, 21
"/Users/ali/cs5510/Group-Project-5510/RLU-Project-DEC7/RLU-Project/target/generated-sources/annotations/rlu/benchmarks/jmh_generated/RluFineBSTBenchmark_ThreadState_jmhType.java", "Java", 0, 3, 0, 0, 2, 5
"/Users/ali/cs5510/Group-Project-5510/RLU-Project-DEC7/RLU-Project/target/generated-sources/annotations/rlu/benchmarks/jmh_generated/RluFineBSTBenchmark_ThreadState_jmhType_B1.java", "Java", 0, 20, 0, 0, 1, 21
"/Users/ali/cs5510/Group-Project-5510/RLU-Project-DEC7/RLU-Project/target/generated-sources/annotations/rlu/benchmarks/jmh_generated/RluFineBSTBenchmark_ThreadState_jmhType_B2.java", "Java", 0, 16, 0, 0, 4, 20
"/Users/ali/cs5510/Group-Project-5510/RLU-Project-DEC7/RLU-Project/target/generated-sources/annotations/rlu/benchmarks/jmh_generated/RluFineBSTBenchmark_ThreadState_jmhType_B3.java", "Java", 0, 19, 0, 0, 2, 21
"/Users/ali/cs5510/Group-Project-5510/RLU-Project-DEC7/RLU-Project/target/generated-sources/annotations/rlu/benchmarks/jmh_generated/RluFineBSTBenchmark_g16for20_jmhTest.java", "Java", 0, 1726, 0, 0, 69, 1795
"/Users/ali/cs5510/Group-Project-5510/RLU-Project-DEC7/RLU-Project/target/generated-sources/annotations/rlu/benchmarks/jmh_generated/RluFineBSTBenchmark_g16for40_jmhTest.java", "Java", 0, 1726, 0, 0, 69, 1795
"/Users/ali/cs5510/Group-Project-5510/RLU-Project-DEC7/RLU-Project/target/generated-sources/annotations/rlu/benchmarks/jmh_generated/RluFineBSTBenchmark_g16for60_jmhTest.java", "Java", 0, 1726, 0, 0, 69, 1795
"/Users/ali/cs5510/Group-Project-5510/RLU-Project-DEC7/RLU-Project/target/generated-sources/annotations/rlu/benchmarks/jmh_generated/RluFineBSTBenchmark_g16for80_jmhTest.java", "Java", 0, 1726, 0, 0, 69, 1795
"/Users/ali/cs5510/Group-Project-5510/RLU-Project-DEC7/RLU-Project/target/generated-sources/annotations/rlu/benchmarks/jmh_generated/RluFineBSTBenchmark_g24for20_jmhTest.java", "Java", 0, 1726, 0, 0, 69, 1795
"/Users/ali/cs5510/Group-Project-5510/RLU-Project-DEC7/RLU-Project/target/generated-sources/annotations/rlu/benchmarks/jmh_generated/RluFineBSTBenchmark_g24for40_jmhTest.java", "Java", 0, 1726, 0, 0, 69, 1795
"/Users/ali/cs5510/Group-Project-5510/RLU-Project-DEC7/RLU-Project/target/generated-sources/annotations/rlu/benchmarks/jmh_generated/RluFineBSTBenchmark_g24for60_jmhTest.java", "Java", 0, 1726, 0, 0, 69, 1795
"/Users/ali/cs5510/Group-Project-5510/RLU-Project-DEC7/RLU-Project/target/generated-sources/annotations/rlu/benchmarks/jmh_generated/RluFineBSTBenchmark_g24for80_jmhTest.java", "Java", 0, 1726, 0, 0, 69, 1795
"/Users/ali/cs5510/Group-Project-5510/RLU-Project-DEC7/RLU-Project/target/generated-sources/annotations/rlu/benchmarks/jmh_generated/RluFineBSTBenchmark_g32for20_jmhTest.java", "Java", 0, 1726, 0, 0, 69, 1795
"/Users/ali/cs5510/Group-Project-5510/RLU-Project-DEC7/RLU-Project/target/generated-sources/annotations/rlu/benchmarks/jmh_generated/RluFineBSTBenchmark_g32for40_jmhTest.java", "Java", 0, 1726, 0, 0, 69, 1795
"/Users/ali/cs5510/Group-Project-5510/RLU-Project-DEC7/RLU-Project/target/generated-sources/annotations/rlu/benchmarks/jmh_generated/RluFineBSTBenchmark_g32for60_jmhTest.java", "Java", 0, 1726, 0, 0, 69, 1795
"/Users/ali/cs5510/Group-Project-5510/RLU-Project-DEC7/RLU-Project/target/generated-sources/annotations/rlu/benchmarks/jmh_generated/RluFineBSTBenchmark_g32for80_jmhTest.java", "Java", 0, 1726, 0, 0, 69, 1795
"/Users/ali/cs5510/Group-Project-5510/RLU-Project-DEC7/RLU-Project/target/generated-sources/annotations/rlu/benchmarks/jmh_generated/RluFineBSTBenchmark_g8for20_jmhTest.java", "Java", 0, 1726, 0, 0, 69, 1795
"/Users/ali/cs5510/Group-Project-5510/RLU-Project-DEC7/RLU-Project/target/generated-sources/annotations/rlu/benchmarks/jmh_generated/RluFineBSTBenchmark_g8for40_jmhTest.java", "Java", 0, 1726, 0, 0, 69, 1795
"/Users/ali/cs5510/Group-Project-5510/RLU-Project-DEC7/RLU-Project/target/generated-sources/annotations/rlu/benchmarks/jmh_generated/RluFineBSTBenchmark_g8for60_jmhTest.java", "Java", 0, 1726, 0, 0, 69, 1795
"/Users/ali/cs5510/Group-Project-5510/RLU-Project-DEC7/RLU-Project/target/generated-sources/annotations/rlu/benchmarks/jmh_generated/RluFineBSTBenchmark_g8for80_jmhTest.java", "Java", 0, 1726, 0, 0, 69, 1795
"/Users/ali/cs5510/Group-Project-5510/RLU-Project-DEC7/RLU-Project/target/generated-sources/annotations/rlu/benchmarks/jmh_generated/RluFineBSTBenchmark_jmhType.java", "Java", 0, 3, 0, 0, 2, 5
"/Users/ali/cs5510/Group-Project-5510/RLU-Project-DEC7/RLU-Project/target/generated-sources/annotations/rlu/benchmarks/jmh_generated/RluFineBSTBenchmark_jmhType_B1.java", "Java", 0, 20, 0, 0, 1, 21
"/Users/ali/cs5510/Group-Project-5510/RLU-Project-DEC7/RLU-Project/target/generated-sources/annotations/rlu/benchmarks/jmh_generated/RluFineBSTBenchmark_jmhType_B2.java", "Java", 0, 19, 0, 0, 4, 23
"/Users/ali/cs5510/Group-Project-5510/RLU-Project-DEC7/RLU-Project/target/generated-sources/annotations/rlu/benchmarks/jmh_generated/RluFineBSTBenchmark_jmhType_B3.java", "Java", 0, 19, 0, 0, 2, 21
"/Users/ali/cs5510/Group-Project-5510/RLU-Project-DEC7/RLU-Project/target/generated-sources/annotations/rlu/benchmarks/jmh_generated/RluMultiObjectSetBenchmark_GlobalState_jmhType.java", "Java", 0, 3, 0, 0, 2, 5
"/Users/ali/cs5510/Group-Project-5510/RLU-Project-DEC7/RLU-Project/target/generated-sources/annotations/rlu/benchmarks/jmh_generated/RluMultiObjectSetBenchmark_GlobalState_jmhType_B1.java", "Java", 0, 20, 0, 0, 1, 21
"/Users/ali/cs5510/Group-Project-5510/RLU-Project-DEC7/RLU-Project/target/generated-sources/annotations/rlu/benchmarks/jmh_generated/RluMultiObjectSetBenchmark_GlobalState_jmhType_B2.java", "Java", 0, 19, 0, 0, 4, 23
"/Users/ali/cs5510/Group-Project-5510/RLU-Project-DEC7/RLU-Project/target/generated-sources/annotations/rlu/benchmarks/jmh_generated/RluMultiObjectSetBenchmark_GlobalState_jmhType_B3.java", "Java", 0, 19, 0, 0, 2, 21
"/Users/ali/cs5510/Group-Project-5510/RLU-Project-DEC7/RLU-Project/target/generated-sources/annotations/rlu/benchmarks/jmh_generated/RluMultiObjectSetBenchmark_ThreadState_jmhType.java", "Java", 0, 3, 0, 0, 2, 5
"/Users/ali/cs5510/Group-Project-5510/RLU-Project-DEC7/RLU-Project/target/generated-sources/annotations/rlu/benchmarks/jmh_generated/RluMultiObjectSetBenchmark_ThreadState_jmhType_B1.java", "Java", 0, 20, 0, 0, 1, 21
"/Users/ali/cs5510/Group-Project-5510/RLU-Project-DEC7/RLU-Project/target/generated-sources/annotations/rlu/benchmarks/jmh_generated/RluMultiObjectSetBenchmark_ThreadState_jmhType_B2.java", "Java", 0, 16, 0, 0, 4, 20
"/Users/ali/cs5510/Group-Project-5510/RLU-Project-DEC7/RLU-Project/target/generated-sources/annotations/rlu/benchmarks/jmh_generated/RluMultiObjectSetBenchmark_ThreadState_jmhType_B3.java", "Java", 0, 19, 0, 0, 2, 21
"/Users/ali/cs5510/Group-Project-5510/RLU-Project-DEC7/RLU-Project/target/generated-sources/annotations/rlu/benchmarks/jmh_generated/RluMultiObjectSetBenchmark_g16for20_jmhTest.java", "Java", 0, 1726, 0, 0, 69, 1795
"/Users/ali/cs5510/Group-Project-5510/RLU-Project-DEC7/RLU-Project/target/generated-sources/annotations/rlu/benchmarks/jmh_generated/RluMultiObjectSetBenchmark_g16for40_jmhTest.java", "Java", 0, 1726, 0, 0, 69, 1795
"/Users/ali/cs5510/Group-Project-5510/RLU-Project-DEC7/RLU-Project/target/generated-sources/annotations/rlu/benchmarks/jmh_generated/RluMultiObjectSetBenchmark_g16for60_jmhTest.java", "Java", 0, 1726, 0, 0, 69, 1795
"/Users/ali/cs5510/Group-Project-5510/RLU-Project-DEC7/RLU-Project/target/generated-sources/annotations/rlu/benchmarks/jmh_generated/RluMultiObjectSetBenchmark_g16for80_jmhTest.java", "Java", 0, 1726, 0, 0, 69, 1795
"/Users/ali/cs5510/Group-Project-5510/RLU-Project-DEC7/RLU-Project/target/generated-sources/annotations/rlu/benchmarks/jmh_generated/RluMultiObjectSetBenchmark_g24for20_jmhTest.java", "Java", 0, 1726, 0, 0, 69, 1795
"/Users/ali/cs5510/Group-Project-5510/RLU-Project-DEC7/RLU-Project/target/generated-sources/annotations/rlu/benchmarks/jmh_generated/RluMultiObjectSetBenchmark_g24for40_jmhTest.java", "Java", 0, 1726, 0, 0, 69, 1795
"/Users/ali/cs5510/Group-Project-5510/RLU-Project-DEC7/RLU-Project/target/generated-sources/annotations/rlu/benchmarks/jmh_generated/RluMultiObjectSetBenchmark_g24for60_jmhTest.java", "Java", 0, 1726, 0, 0, 69, 1795
"/Users/ali/cs5510/Group-Project-5510/RLU-Project-DEC7/RLU-Project/target/generated-sources/annotations/rlu/benchmarks/jmh_generated/RluMultiObjectSetBenchmark_g24for80_jmhTest.java", "Java", 0, 1726, 0, 0, 69, 1795
"/Users/ali/cs5510/Group-Project-5510/RLU-Project-DEC7/RLU-Project/target/generated-sources/annotations/rlu/benchmarks/jmh_generated/RluMultiObjectSetBenchmark_g32for20_jmhTest.java", "Java", 0, 1726, 0, 0, 69, 1795
"/Users/ali/cs5510/Group-Project-5510/RLU-Project-DEC7/RLU-Project/target/generated-sources/annotations/rlu/benchmarks/jmh_generated/RluMultiObjectSetBenchmark_g32for40_jmhTest.java", "Java", 0, 1726, 0, 0, 69, 1795
"/Users/ali/cs5510/Group-Project-5510/RLU-Project-DEC7/RLU-Project/target/generated-sources/annotations/rlu/benchmarks/jmh_generated/RluMultiObjectSetBenchmark_g32for60_jmhTest.java", "Java", 0, 1726, 0, 0, 69, 1795
"/Users/ali/cs5510/Group-Project-5510/RLU-Project-DEC7/RLU-Project/target/generated-sources/annotations/rlu/benchmarks/jmh_generated/RluMultiObjectSetBenchmark_g32for80_jmhTest.java", "Java", 0, 1726, 0, 0, 69, 1795
"/Users/ali/cs5510/Group-Project-5510/RLU-Project-DEC7/RLU-Project/target/generated-sources/annotations/rlu/benchmarks/jmh_generated/RluMultiObjectSetBenchmark_g8for20_jmhTest.java", "Java", 0, 1726, 0, 0, 69, 1795
"/Users/ali/cs5510/Group-Project-5510/RLU-Project-DEC7/RLU-Project/target/generated-sources/annotations/rlu/benchmarks/jmh_generated/RluMultiObjectSetBenchmark_g8for40_jmhTest.java", "Java", 0, 1726, 0, 0, 69, 1795
"/Users/ali/cs5510/Group-Project-5510/RLU-Project-DEC7/RLU-Project/target/generated-sources/annotations/rlu/benchmarks/jmh_generated/RluMultiObjectSetBenchmark_g8for60_jmhTest.java", "Java", 0, 1726, 0, 0, 69, 1795
"/Users/ali/cs5510/Group-Project-5510/RLU-Project-DEC7/RLU-Project/target/generated-sources/annotations/rlu/benchmarks/jmh_generated/RluMultiObjectSetBenchmark_g8for80_jmhTest.java", "Java", 0, 1726, 0, 0, 69, 1795
"/Users/ali/cs5510/Group-Project-5510/RLU-Project-DEC7/RLU-Project/target/generated-sources/annotations/rlu/benchmarks/jmh_generated/RluMultiObjectSetBenchmark_jmhType.java", "Java", 0, 3, 0, 0, 2, 5
"/Users/ali/cs5510/Group-Project-5510/RLU-Project-DEC7/RLU-Project/target/generated-sources/annotations/rlu/benchmarks/jmh_generated/RluMultiObjectSetBenchmark_jmhType_B1.java", "Java", 0, 20, 0, 0, 1, 21
"/Users/ali/cs5510/Group-Project-5510/RLU-Project-DEC7/RLU-Project/target/generated-sources/annotations/rlu/benchmarks/jmh_generated/RluMultiObjectSetBenchmark_jmhType_B2.java", "Java", 0, 19, 0, 0, 4, 23
"/Users/ali/cs5510/Group-Project-5510/RLU-Project-DEC7/RLU-Project/target/generated-sources/annotations/rlu/benchmarks/jmh_generated/RluMultiObjectSetBenchmark_jmhType_B3.java", "Java", 0, 19, 0, 0, 2, 21
"/Users/ali/cs5510/Group-Project-5510/RLU-Project-DEC7/RLU-Project/target/generated-sources/annotations/rlu/benchmarks/jmh_generated/URCUCGSetBenchmark_GlobalState_jmhType.java", "Java", 0, 3, 0, 0, 2, 5
"/Users/ali/cs5510/Group-Project-5510/RLU-Project-DEC7/RLU-Project/target/generated-sources/annotations/rlu/benchmarks/jmh_generated/URCUCGSetBenchmark_GlobalState_jmhType_B1.java", "Java", 0, 20, 0, 0, 1, 21
"/Users/ali/cs5510/Group-Project-5510/RLU-Project-DEC7/RLU-Project/target/generated-sources/annotations/rlu/benchmarks/jmh_generated/URCUCGSetBenchmark_GlobalState_jmhType_B2.java", "Java", 0, 19, 0, 0, 4, 23
"/Users/ali/cs5510/Group-Project-5510/RLU-Project-DEC7/RLU-Project/target/generated-sources/annotations/rlu/benchmarks/jmh_generated/URCUCGSetBenchmark_GlobalState_jmhType_B3.java", "Java", 0, 19, 0, 0, 2, 21
"/Users/ali/cs5510/Group-Project-5510/RLU-Project-DEC7/RLU-Project/target/generated-sources/annotations/rlu/benchmarks/jmh_generated/URCUCGSetBenchmark_ThreadState_jmhType.java", "Java", 0, 3, 0, 0, 2, 5
"/Users/ali/cs5510/Group-Project-5510/RLU-Project-DEC7/RLU-Project/target/generated-sources/annotations/rlu/benchmarks/jmh_generated/URCUCGSetBenchmark_ThreadState_jmhType_B1.java", "Java", 0, 20, 0, 0, 1, 21
"/Users/ali/cs5510/Group-Project-5510/RLU-Project-DEC7/RLU-Project/target/generated-sources/annotations/rlu/benchmarks/jmh_generated/URCUCGSetBenchmark_ThreadState_jmhType_B2.java", "Java", 0, 16, 0, 0, 4, 20
"/Users/ali/cs5510/Group-Project-5510/RLU-Project-DEC7/RLU-Project/target/generated-sources/annotations/rlu/benchmarks/jmh_generated/URCUCGSetBenchmark_ThreadState_jmhType_B3.java", "Java", 0, 19, 0, 0, 2, 21
"/Users/ali/cs5510/Group-Project-5510/RLU-Project-DEC7/RLU-Project/target/generated-sources/annotations/rlu/benchmarks/jmh_generated/URCUCGSetBenchmark_g16for20_jmhTest.java", "Java", 0, 1726, 0, 0, 69, 1795
"/Users/ali/cs5510/Group-Project-5510/RLU-Project-DEC7/RLU-Project/target/generated-sources/annotations/rlu/benchmarks/jmh_generated/URCUCGSetBenchmark_g16for40_jmhTest.java", "Java", 0, 1726, 0, 0, 69, 1795
"/Users/ali/cs5510/Group-Project-5510/RLU-Project-DEC7/RLU-Project/target/generated-sources/annotations/rlu/benchmarks/jmh_generated/URCUCGSetBenchmark_g16for60_jmhTest.java", "Java", 0, 1726, 0, 0, 69, 1795
"/Users/ali/cs5510/Group-Project-5510/RLU-Project-DEC7/RLU-Project/target/generated-sources/annotations/rlu/benchmarks/jmh_generated/URCUCGSetBenchmark_g16for80_jmhTest.java", "Java", 0, 1726, 0, 0, 69, 1795
"/Users/ali/cs5510/Group-Project-5510/RLU-Project-DEC7/RLU-Project/target/generated-sources/annotations/rlu/benchmarks/jmh_generated/URCUCGSetBenchmark_g24for20_jmhTest.java", "Java", 0, 1726, 0, 0, 69, 1795
"/Users/ali/cs5510/Group-Project-5510/RLU-Project-DEC7/RLU-Project/target/generated-sources/annotations/rlu/benchmarks/jmh_generated/URCUCGSetBenchmark_g24for40_jmhTest.java", "Java", 0, 1726, 0, 0, 69, 1795
"/Users/ali/cs5510/Group-Project-5510/RLU-Project-DEC7/RLU-Project/target/generated-sources/annotations/rlu/benchmarks/jmh_generated/URCUCGSetBenchmark_g24for60_jmhTest.java", "Java", 0, 1726, 0, 0, 69, 1795
"/Users/ali/cs5510/Group-Project-5510/RLU-Project-DEC7/RLU-Project/target/generated-sources/annotations/rlu/benchmarks/jmh_generated/URCUCGSetBenchmark_g24for80_jmhTest.java", "Java", 0, 1726, 0, 0, 69, 1795
"/Users/ali/cs5510/Group-Project-5510/RLU-Project-DEC7/RLU-Project/target/generated-sources/annotations/rlu/benchmarks/jmh_generated/URCUCGSetBenchmark_g32for20_jmhTest.java", "Java", 0, 1726, 0, 0, 69, 1795
"/Users/ali/cs5510/Group-Project-5510/RLU-Project-DEC7/RLU-Project/target/generated-sources/annotations/rlu/benchmarks/jmh_generated/URCUCGSetBenchmark_g32for40_jmhTest.java", "Java", 0, 1726, 0, 0, 69, 1795
"/Users/ali/cs5510/Group-Project-5510/RLU-Project-DEC7/RLU-Project/target/generated-sources/annotations/rlu/benchmarks/jmh_generated/URCUCGSetBenchmark_g32for60_jmhTest.java", "Java", 0, 1726, 0, 0, 69, 1795
"/Users/ali/cs5510/Group-Project-5510/RLU-Project-DEC7/RLU-Project/target/generated-sources/annotations/rlu/benchmarks/jmh_generated/URCUCGSetBenchmark_g32for80_jmhTest.java", "Java", 0, 1726, 0, 0, 69, 1795
"/Users/ali/cs5510/Group-Project-5510/RLU-Project-DEC7/RLU-Project/target/generated-sources/annotations/rlu/benchmarks/jmh_generated/URCUCGSetBenchmark_g8for20_jmhTest.java", "Java", 0, 1726, 0, 0, 69, 1795
"/Users/ali/cs5510/Group-Project-5510/RLU-Project-DEC7/RLU-Project/target/generated-sources/annotations/rlu/benchmarks/jmh_generated/URCUCGSetBenchmark_g8for40_jmhTest.java", "Java", 0, 1726, 0, 0, 69, 1795
"/Users/ali/cs5510/Group-Project-5510/RLU-Project-DEC7/RLU-Project/target/generated-sources/annotations/rlu/benchmarks/jmh_generated/URCUCGSetBenchmark_g8for60_jmhTest.java", "Java", 0, 1726, 0, 0, 69, 1795
"/Users/ali/cs5510/Group-Project-5510/RLU-Project-DEC7/RLU-Project/target/generated-sources/annotations/rlu/benchmarks/jmh_generated/URCUCGSetBenchmark_g8for80_jmhTest.java", "Java", 0, 1726, 0, 0, 69, 1795
"/Users/ali/cs5510/Group-Project-5510/RLU-Project-DEC7/RLU-Project/target/generated-sources/annotations/rlu/benchmarks/jmh_generated/URCUCGSetBenchmark_jmhType.java", "Java", 0, 3, 0, 0, 2, 5
"/Users/ali/cs5510/Group-Project-5510/RLU-Project-DEC7/RLU-Project/target/generated-sources/annotations/rlu/benchmarks/jmh_generated/URCUCGSetBenchmark_jmhType_B1.java", "Java", 0, 20, 0, 0, 1, 21
"/Users/ali/cs5510/Group-Project-5510/RLU-Project-DEC7/RLU-Project/target/generated-sources/annotations/rlu/benchmarks/jmh_generated/URCUCGSetBenchmark_jmhType_B2.java", "Java", 0, 19, 0, 0, 4, 23
"/Users/ali/cs5510/Group-Project-5510/RLU-Project-DEC7/RLU-Project/target/generated-sources/annotations/rlu/benchmarks/jmh_generated/URCUCGSetBenchmark_jmhType_B3.java", "Java", 0, 19, 0, 0, 2, 21
"/Users/ali/cs5510/Group-Project-5510/RLU-Project-DEC7/RLU-Project/target/generated-sources/annotations/rlu/benchmarks/jmh_generated/URCUFGSetBenchmark_GlobalState_jmhType.java", "Java", 0, 3, 0, 0, 2, 5
"/Users/ali/cs5510/Group-Project-5510/RLU-Project-DEC7/RLU-Project/target/generated-sources/annotations/rlu/benchmarks/jmh_generated/URCUFGSetBenchmark_GlobalState_jmhType_B1.java", "Java", 0, 20, 0, 0, 1, 21
"/Users/ali/cs5510/Group-Project-5510/RLU-Project-DEC7/RLU-Project/target/generated-sources/annotations/rlu/benchmarks/jmh_generated/URCUFGSetBenchmark_GlobalState_jmhType_B2.java", "Java", 0, 19, 0, 0, 4, 23
"/Users/ali/cs5510/Group-Project-5510/RLU-Project-DEC7/RLU-Project/target/generated-sources/annotations/rlu/benchmarks/jmh_generated/URCUFGSetBenchmark_GlobalState_jmhType_B3.java", "Java", 0, 19, 0, 0, 2, 21
"/Users/ali/cs5510/Group-Project-5510/RLU-Project-DEC7/RLU-Project/target/generated-sources/annotations/rlu/benchmarks/jmh_generated/URCUFGSetBenchmark_ThreadState_jmhType.java", "Java", 0, 3, 0, 0, 2, 5
"/Users/ali/cs5510/Group-Project-5510/RLU-Project-DEC7/RLU-Project/target/generated-sources/annotations/rlu/benchmarks/jmh_generated/URCUFGSetBenchmark_ThreadState_jmhType_B1.java", "Java", 0, 20, 0, 0, 1, 21
"/Users/ali/cs5510/Group-Project-5510/RLU-Project-DEC7/RLU-Project/target/generated-sources/annotations/rlu/benchmarks/jmh_generated/URCUFGSetBenchmark_ThreadState_jmhType_B2.java", "Java", 0, 16, 0, 0, 4, 20
"/Users/ali/cs5510/Group-Project-5510/RLU-Project-DEC7/RLU-Project/target/generated-sources/annotations/rlu/benchmarks/jmh_generated/URCUFGSetBenchmark_ThreadState_jmhType_B3.java", "Java", 0, 19, 0, 0, 2, 21
"/Users/ali/cs5510/Group-Project-5510/RLU-Project-DEC7/RLU-Project/target/generated-sources/annotations/rlu/benchmarks/jmh_generated/URCUFGSetBenchmark_g16for20_jmhTest.java", "Java", 0, 1726, 0, 0, 69, 1795
"/Users/ali/cs5510/Group-Project-5510/RLU-Project-DEC7/RLU-Project/target/generated-sources/annotations/rlu/benchmarks/jmh_generated/URCUFGSetBenchmark_g16for40_jmhTest.java", "Java", 0, 1726, 0, 0, 69, 1795
"/Users/ali/cs5510/Group-Project-5510/RLU-Project-DEC7/RLU-Project/target/generated-sources/annotations/rlu/benchmarks/jmh_generated/URCUFGSetBenchmark_g16for60_jmhTest.java", "Java", 0, 1726, 0, 0, 69, 1795
"/Users/ali/cs5510/Group-Project-5510/RLU-Project-DEC7/RLU-Project/target/generated-sources/annotations/rlu/benchmarks/jmh_generated/URCUFGSetBenchmark_g16for80_jmhTest.java", "Java", 0, 1726, 0, 0, 69, 1795
"/Users/ali/cs5510/Group-Project-5510/RLU-Project-DEC7/RLU-Project/target/generated-sources/annotations/rlu/benchmarks/jmh_generated/URCUFGSetBenchmark_g24for20_jmhTest.java", "Java", 0, 1726, 0, 0, 69, 1795
"/Users/ali/cs5510/Group-Project-5510/RLU-Project-DEC7/RLU-Project/target/generated-sources/annotations/rlu/benchmarks/jmh_generated/URCUFGSetBenchmark_g24for40_jmhTest.java", "Java", 0, 1726, 0, 0, 69, 1795
"/Users/ali/cs5510/Group-Project-5510/RLU-Project-DEC7/RLU-Project/target/generated-sources/annotations/rlu/benchmarks/jmh_generated/URCUFGSetBenchmark_g24for60_jmhTest.java", "Java", 0, 1726, 0, 0, 69, 1795
"/Users/ali/cs5510/Group-Project-5510/RLU-Project-DEC7/RLU-Project/target/generated-sources/annotations/rlu/benchmarks/jmh_generated/URCUFGSetBenchmark_g24for80_jmhTest.java", "Java", 0, 1726, 0, 0, 69, 1795
"/Users/ali/cs5510/Group-Project-5510/RLU-Project-DEC7/RLU-Project/target/generated-sources/annotations/rlu/benchmarks/jmh_generated/URCUFGSetBenchmark_g32for20_jmhTest.java", "Java", 0, 1726, 0, 0, 69, 1795
"/Users/ali/cs5510/Group-Project-5510/RLU-Project-DEC7/RLU-Project/target/generated-sources/annotations/rlu/benchmarks/jmh_generated/URCUFGSetBenchmark_g32for40_jmhTest.java", "Java", 0, 1726, 0, 0, 69, 1795
"/Users/ali/cs5510/Group-Project-5510/RLU-Project-DEC7/RLU-Project/target/generated-sources/annotations/rlu/benchmarks/jmh_generated/URCUFGSetBenchmark_g32for60_jmhTest.java", "Java", 0, 1726, 0, 0, 69, 1795
"/Users/ali/cs5510/Group-Project-5510/RLU-Project-DEC7/RLU-Project/target/generated-sources/annotations/rlu/benchmarks/jmh_generated/URCUFGSetBenchmark_g32for80_jmhTest.java", "Java", 0, 1726, 0, 0, 69, 1795
"/Users/ali/cs5510/Group-Project-5510/RLU-Project-DEC7/RLU-Project/target/generated-sources/annotations/rlu/benchmarks/jmh_generated/URCUFGSetBenchmark_g8for20_jmhTest.java", "Java", 0, 1726, 0, 0, 69, 1795
"/Users/ali/cs5510/Group-Project-5510/RLU-Project-DEC7/RLU-Project/target/generated-sources/annotations/rlu/benchmarks/jmh_generated/URCUFGSetBenchmark_g8for40_jmhTest.java", "Java", 0, 1726, 0, 0, 69, 1795
"/Users/ali/cs5510/Group-Project-5510/RLU-Project-DEC7/RLU-Project/target/generated-sources/annotations/rlu/benchmarks/jmh_generated/URCUFGSetBenchmark_g8for60_jmhTest.java", "Java", 0, 1726, 0, 0, 69, 1795
"/Users/ali/cs5510/Group-Project-5510/RLU-Project-DEC7/RLU-Project/target/generated-sources/annotations/rlu/benchmarks/jmh_generated/URCUFGSetBenchmark_g8for80_jmhTest.java", "Java", 0, 1726, 0, 0, 69, 1795
"/Users/ali/cs5510/Group-Project-5510/RLU-Project-DEC7/RLU-Project/target/generated-sources/annotations/rlu/benchmarks/jmh_generated/URCUFGSetBenchmark_jmhType.java", "Java", 0, 3, 0, 0, 2, 5
"/Users/ali/cs5510/Group-Project-5510/RLU-Project-DEC7/RLU-Project/target/generated-sources/annotations/rlu/benchmarks/jmh_generated/URCUFGSetBenchmark_jmhType_B1.java", "Java", 0, 20, 0, 0, 1, 21
"/Users/ali/cs5510/Group-Project-5510/RLU-Project-DEC7/RLU-Project/target/generated-sources/annotations/rlu/benchmarks/jmh_generated/URCUFGSetBenchmark_jmhType_B2.java", "Java", 0, 19, 0, 0, 4, 23
"/Users/ali/cs5510/Group-Project-5510/RLU-Project-DEC7/RLU-Project/target/generated-sources/annotations/rlu/benchmarks/jmh_generated/URCUFGSetBenchmark_jmhType_B3.java", "Java", 0, 19, 0, 0, 2, 21
"/Users/ali/cs5510/Group-Project-5510/RLU-Project-DEC7/RLU-Project/target/maven-archiver/pom.properties", "Java Properties", 0, 0, 3, 2, 1, 6
"Total", "-", 296, 440901, 3, 1306, 15908, 458414